ADCNSXSH	ád dụng công nghệ sản xuất sạch hơn
AHLLVT	anh hùng lực lượng vũ trang
AHLLVTND	anh hùng lực lượng vũ trang nhân dân
AHLS	anh hùng liệt sĩ
AHLĐ	anh hùng lao động
ANND	an ninh nhân dân
ANQG	an ninh quốc gia
ANQP	an ninh quốc phòng
ANTG	an ninh thế giới
ANTQ	an ninh tổ quốc
ANTT	an ninh trật tự
ANTTVH	an ninh tư tưởng văn hóa
ANTĐ	an ninh thủ đô
ANVH	an ninh văn hóa
ANĐT	an ninh điều tra
ASXH	an sinh xã hội
ATBXHN	an toàn bức xạ hạt nhân
ATGT	an toàn giao thông
ATGTQG	an toàn giao thông quốc gia
ATKT	an toàn kỹ thuật
ATLĐ	an toàn lao động
ATNĐ	áp thấp nhiệt đới
ATTP	an toàn thực phẩm
ATVS	an toàn vệ sinh
ATVSLĐ	an toàn vệ sinh lao động
ATVSTP	an toàn vệ sinh thực phẩm
ATVSV	an toàn vệ sinh viên
ATĐB	an toàn đường bộ
BACN	bữa ăn công nghiệp
BBCVT	bộ bưu chính viễn thông
BBT	ban biên tập
BBVT	bến bãi vận tãi
BCBB	bóng chuyền bãi biển
BCHBP	bộ chỉ huy biên phòng
BCHCĐ	ban chấp hành công đoàn
BCHCĐCS	ban chấp hành công đoàn cơ sở
BCHPCLB	ban chỉ huy phòng chống lụt bão
BCHQS	ban chỉ huy quân sự
BCHQSTP	bộ chỉ huy quân sự thành phố
BCHT	ban chấp hành trung
BCHTLĐ	ban chấp hành tổng liên đoàn
BCHTW	ban chấp hành trung ương
BCHTƯ	ban chấp hành trung ương
BCKT	báo cáo kiểm toán
BCNCKT	báo cáo nghiên cứu khả thi
BCNĐA	ban chủ nhiệm đề án
BCS	bao cao su
BCSĐ	ban cán sự đảng
BCTC	báo cáo tài chính
BCTT	báo chí tuyên truyền
BCVN	bưu chính việt nam
BCVT	bưu chính viễn thông
BCVTVN	bưu chính viễn thông việt nam
BCĐ	ban chỉ đạo
BCĐPCLB	ban chỉ đạo phòng chống lụt bão
BCĐQG	ban chỉ đạo quốc gia
BCĐT	ban chỉ đạo trung
BCĐTP	ban chỉ đạo tiền phương
BCĐTS	ban chỉ đạo tuyển sinh
BCĐĐMĐH	ban chỉ đạo đổi mới đại học
BDCBYT	bồi dưỡng cán bộ y tế
BDCM	bán đảo cà mau
BDCT	bồi dưỡng chính trị
BDVHX	bưu điện văn hóa xã
BDVN	bóng đá việt nam
BGD	bộ giáo dục
BGH	ban giám hiệu
BGK	ban giám khảo
BGTVT	bộ giao thông vận tải
BGĐ	ban giám đốc
BHGĐ	bạo hành gia đình
BHHS	bảo hiểm học sinh
BHL	ban huấn luyện
BHLĐ	bảo hộ lao động
BHMMTT	bộ hòa mạng mới trả trước
BHNN	bảo hiểm nông nghiệp
BHNT	bảo hiểm nhân thọ
BHTG	bảo hiểm tiền gởi
BHTN	bảo hiểm thất nghiệp
BHTT	bán hàng trực tiếp
BHTY	bài hát tôi yêu
BHVN	bảo hiểm việt nam
BHXH	bảo hiểm xã hội
BHXHTN	bảo hiểm xã hội tự nguyện
BHXHVN	bảo hiểm xã hội việt nam
BHYT	bảo hiểm y tế
BHYTTD	bảo hiểm y tế toàn dân
BHYTTN	bảo hiểm y tế tự nguyện
BK	bán kết
BKH	bộ kế hoạch
BKHCN	bộ khoa học công nghệ
BKHN	bách khoa hà nội
BKHĐT	bộ kế hoạch đầu tư
BKT	ban kỉ thuật
BKVN	bách khoa việt nam
BLDS	bộ luật dân sự
BLGĐ	bạo lực gia đình
BLHS	bộ luật hình sự
BLL	ban liên lạc
BLLĐ	bộ luật lao động
BLTGĐ	bạo lực trong gia đình
BLTL	buôn lậu thuốc lá
BLTTHS	bộ luật tố tụng hình sự
BLV	bình luận viên
BLX	bằng lái xe
BLĐMNV	bệnh lý động mạch ngoại vi
BLĐTB	bộ lao động thương binh
BLĐTBXH	bộ lao động thương binh xã hội
BMSL	bom mìn sót lại
BMTE	bà mẹ trẻ em
BMTK	bộ máy tìm kiếm
BMVNAH	bà mẹ việt nam anh hùng
BNG	bộ ngoại giao
BNN	bộ nông nghiệp
BNSR	bệnh nhân sốt rét
BPCK	biên phòng cửa khẩu
BQBĐ	bản quyền bóng đá
BQL	ban quản lý
BQLC	ban quản lý chợ
BQLDA	ban quản lý dự án
BQLDACTCC	ban quản lý dự án công trình công cộng
BQLDATL	ban quản lý dự án thủy lợi
BQLDATĐ	ban quản lý dự án thủy điện
BQLDL	ban quản lý du lịch
BQLKCNC	ban quản lý khu công nghệ cao
BQLKCX	ban quản lý khu chế xuất
BQLKDL	ban quản lý khu du lịch
BQLR	ban quản lý rừng
BQLRPH	ban quản lý rừng phòng hộ
BQLRPHĐN	ban quản lý rừng phòng hộ đầu nguồn
BQLRĐD	ban quản lý rừng đặc dụng
BQLSC	ban quản lý suối cá
BQP	bộ quốc phòng
BQPM	bản quyền phần mềm
BQTG	bản quyền tác giả
BQTH	bản quyền truyền hình
BR-VT	bà rịa vũng tàu
BRDĐ	băng rộng di động
BRVN	bóng rổ việt nam
BRVT	bà rịa vũng tàu
BS	bác sĩ
BSGĐ	bác sĩ gia đình
BST	bộ sưu tập
BTBG	bất tăng bất giảm
BTBNN	bảo trợ bệnh nhân nghèo
BTC	bộ tài chính
BTCCBCP	ban tổ chức cán bộ chính phủ
BTCN	bảng tra chữ nôm
BTCT	bê tông cốt thép
BTDT	bảo tàng dân tộc
BTDTCĐ	bảo tồn di tích cố đô
BTGPMB	bồi thường giải phóng mặt bằng
BTGĐ	ban tổng giám đốc
BTLSQG	bảo tàng lịch sử quốc gia
BTLSTN	bảo tàng lịch sử tự nhiên
BTM	bộ thương mại
BTNMT	bộ tài nguyên môi trường
BTP	bộ tư pháp
BTQĐ	bảo tàng quân đội
BTTEVN	bảo trợ trẻ em việt nam
BTTH	bồi thường thiệt hại
BTTHPT	bổ túc trung học phổ thông
BTTN	bảo tồn thiên nhiên
BTTNVN	bảo tàng thiên nhiên việt nam
BTTP	bổ trợ tư pháp
BTTT	bảo tàng tuổi trẻ
BTTU	bí thư thành uỷ
BTV	biên tập viên
BTVC	bàn tròn văn chương
BTVH	bổ túc văn hóa
BTXH	bảo trợ xã hội
BTĐKCP	bảo tàng điêu khắc chăm pa
BTĐUK	bí thư đảng ủy khối
BVBM	bệnh viện bạch mai
BVBMTE	bảo vệ bà mẹ trẻ em
BVBĐ	bệnh viện bưu điện
BVCCTV	bệnh viện cấp cứu trưng vương
BVCR	bệnh viện chợ rẫy
BVCSTE	bảo vệ chăm sóc trẻ em
BVHTT	bộ văn hóa thông tin
BVKV	bệnh viện khu vực
BVKVTH	bệnh viện khu vực triệu hải
BVLĐ	bảo vệ lao động
BVM	bệnh viện mắt
BVMP	bệnh viện miễn phí
BVMT	bảo vệ môi trường
BVMTVN	bảo vệ môi trường việt nam
BVNLTS	bảo vệ nguồn lợi thủy sản
BVNTD	bảo vệ người tiêu dùng
BVNTDVN	bảo vệ người tiêu dùng việt nam
BVNĐ	bệnh viện nhi đồng
BVPL	bảo vệ pháp luật
BVPSQTSG	bệnh viện phụ sản quốc tế sài gòn
BVQLNTD	bảo vệ quyền lợi người tiêu dùng
BVQS	bảo vệ quân sự
BVTMHH	bệnh viện truyền máu huyết học
BVTNMT	bảo vệ thiên nhiên môi trường
BVTV	bảo vệ thực vật
BVTVAG	bảo vệ thực vật an giang
BVTVSG	bảo vệ thực vật sài gòn
BVTƯ	bệnh viện trung ương
BVVP	bệnh viện việt pháp
BVYHCTHN	bệnh viện y học cổ truyền hà nội
BVĐHYD	bệnh viện đại học y dược
BVĐK	bệnh viện đa khoa
BVĐKBN	bệnh viện đa khoa bắc ninh
BVĐKBĐ	bệnh viện đa khoa bình định
BVĐKHB	bệnh viện đa khoa hòa bình
BVĐKHY	bệnh viện đa khoa hưng yên
BVĐKT	bệnh viện đa khoa tỉnh
BVĐKTB	bệnh viện đa khoa thái bình
BVĐKTƯ	bệnh viện đa khoa trung ương
BXCL	bến xe chợ lớn
BXD	bộ xây dựng
BXH	bảng xếp hạng
BXMT	bến xe miền tây
BXMĐ	bến xe miền đông
BXĐT	bức xạ điện từ
BYT	bộ y tế
BĐATHH	bảo đảm an toàn hàng hải
BĐBB	bóng đá bãi biển
BĐBL	bưu điện bạc liêu
BĐBP	bộ đội biên phòng
BĐCN	bóng đá chuyên nghiệp
BĐCTM	ba đỉnh cao thơ mới
BĐG	bán đấu giá
BĐH	ban điều hành
BĐHDA	ban điều hành dự án
BĐHN	bưu điện hà nội
BĐKH	biến đổi khí hậu
BĐLA	bình điền long an
BĐN	bồ đào nha
BĐS	bất động sản
BĐT	bất đẳng thức
BĐTN	bóng đá trong nhà
BĐTP	bưu điện thành phố
BĐTS	bộ đội trồng sắn
BĐVH	bưu điện văn hóa
BĐVHX	bưu điện văn hóa xã
BĐVN	bưu điện việt nam
CAHN	công an hà nội
CAHP	công an hải phòng
CAKH	công an khánh hòa
CAND	công an nhân dân
CAPĐV	công an phường đông vệ
CATP	công an thành phố
CATPHCM	công an thành phố hồ chí minh
CATPĐN	công an thành phố đà nẵng
CATX	công an thị xã
CB	cán bộ
CBCC	cán bộ công chức
CBCCVC	cán bộ công chức viên chức
CBCN	cán bộ công nhân
CBCNLĐ	cán bộ công nhân lao động
CBCNV	cán bộ công nhân viên
CBCNVC	cán bộ công nhân viên chức
CBCĐ	cán bộ công đoàn
CBGV	cán bộ giáo viên
CBNLS	chế biến nông lâm sản
CBNV	cán bộ nhân viên
CBNĐ	các bệnh nhiệt đới
CBPG	chống bán phá giá
CBQL	cán bộ quản lý
CBQLGD	cán bộ quản lý giáo dục
CBSK	cảnh báo sức khỏe
CBTBS	chế biến tinh bột sắn
CBTC	công bố tiêu chuẩn
CBTP	chế biến thực phẩm
CBTS	chế biến thủy sản
CBTSXK	chế biến thủy sản xuất khẩu
CBVC	cán bộ viên chức
CBXH	công bằng xã hội
CBYT	cán bộ y tế
CBĐ	cán bộ đảng
CBĐV	cán bộ đảng viên
CCBVN	cựu chiến binh việt nam
CCBVNLTS	chi cục bảo vệ nguồn lợi thủy sản
CCBĐ	cá cược bóng đá
CCCP	căn cước can phạm
CCDV	cung cấp dịch vụ
CCGD	cải cách giáo dục
CCHC	cải cách hành chính
CCHK	cụm cảng hàng không
CCHKMT	cụm cảng hàng không miền trung
CCHKSBMT	cụm cảng hàng không sân bay miền trung
CCMN	cuộc cách mạng nhung
CCNN	chứng chỉ ngoại ngữ
CCPĐ	câu chuyện pháp đình
CCQLCL	chi cục quản lý chất lượng
CCQLTS	chi cục quản lý thủy sản
CCQLTT	chi cục quản lý thị trường
CCQLTTHP	chi cục quản lý thị trường hải phòng
CCRĐ	cải cách ruộng đất
CCTC	công cụ tài chính
CCTCĐLCL	chi cục tiêu chuẩn đo lường chất lượng
CCTG	chứng chỉ tiền gởi
CCTH	cấp cứu tổng hợp
CCTN	cồng chiêng tây nguyên
CCTP	cải cách tư pháp
CCTT	công cụ thiên tài
CCTY	câu chuyện tình yêu
CCVC	công chức viên chức
CCĐSPN	chi cục đường sông phía nam
CDAT	cộng đồng an toàn
CDDC	chất độc da cam
CDDL	chỉ dẫn địa lý
CDGSNN	chức danh giáo sư nhà nước
CGCN	chuyển giao công nghệ
CGQSDĐ	chuyển giao quyền sử dụng đất
CGĐQLCL	cục giám định quản lý chất lượng
CH	cộng hòa
CHBP	chỉ huy biên phòng
CHCC	căn hộ chung cư
CHCN	cứu hộ cứu nạn
CHDC	cộng hòa dân chủ
CHDCND	cộng hòa dân chủ nhân dân
CHHMH	chỉnh hình họng màn hầu
CHKT	cao học kinh tế
CHLB	cộng hòa liên bang
CHLBĐ	cộng hòa liên bang đức
CHND	cộng hòa nhân dân
CHPCLB	chỉ huy phòng chống lụt bão
CHQS	chỉ huy quân sự
CHRM	chỉnh hình răng mặt
CHTW	chấp hành trung ương
CHXH	cộng hòa xã hội
CHXHCN	cộng hòa xã hội chủ nghĩa
CHXHCNVN	cộng hòa xã hội chủ nghĩa việt nam
CK	chung kết
CKNN	chứng khoán nhà nước
CKTT	chiết khấu thanh toán
CKVN	chứng khoán việt nam
CKXD	cơ khí xây dựng
CLB	câu lạc bộ
CLBBĐ	câu lạc bộ bóng đá
CLBHK	câu lạc bộ hàng không
CLBPN	câu lạc bộ phụ nữ
CLBQĐ	câu lạc bộ quân đội
CLBTP	câu lạc bộ tiếng pháp
CLC	chất lượng cao
CLGD	chất lượng giáo dục
CLQG	chiến lược quốc gia
CLSPHH	chất lượng sản phẩm hàng hóa
CMHS	cha mẹ học sinh
CMLT	cách mạng lâm thời
CMND	chứng minh nhân dân
CMTM	cách mạng tháng mười
CMTND	chứng minh thư nhân dân
CMTT	cách mạng tháng tám
CMVH	cách mạng văn hóa
CMĐSDĐ	chuyển mục đích sử dụng đất
CNBCVT	công nghệ bưu chính viễn thông
CNCKSG	công nghiệp cơ khí sài gòn
CNCL	công nghiệp chủ lực
CNCĐ	công nhân cơ điện
CNDVĐT	công nghiệp dịch vụ đô thị
CNGC	công nghiệp gia công
CNH	công nghiệp hóa
CNKT	công nhân kỹ thuật
CNLĐ	công nhân lao động
CNNHCSXH	chi nhánh ngân hàng chính sách xã hội
CNNT	công nghiệp nông thôn
CNPM	công nghệ phần mềm
CNQG	chính nghĩa quốc gia
CNQP	công nghiệp quốc phòng
CNQSD	chứng nhận quyền sử dụng
CNQSDĐ	chứng nhận quyền sử dụng đất
CNQSHĐ	chứng nhận quyền sở hữu đất
CNSH	công nghệ sinh học
CNTB	chủ nghĩa tư bản
CNTD	chuyển nhượng tự do
CNTN	cử nhân tài năng
CNTT	công nghệ thông tin
CNTTVN	công nghiệp tàu thủy việt nam
CNV	công nhân viên
CNVC	công nhân viên chức
CNVCLĐ	công nhân viên chức lao động
CNVL	công nghệ vật liệu
CNVN	công nhân việt nam
CNVQP	công nhân viên quốc phòng
CNVT	công nghệ vũ trụ
CNXH	chủ nghĩa xã hội
CPBV	cổ phiếu bảo việt
CPBVTV	cổ phần bảo vệ thực vật
CPBXKTN	công ty cổ phần bến xe khách tây ninh
CPBĐ	cổ phần bóng đá
CPBĐPNRĐ	cổ phần bóng đèn phích nước rạng đông
CPCK	cổ phần chứng khoán
CPCKXD	cổ phần cơ khí xây dựng
CPCMVNTD	chính phủ cách mạng việt nam tự do
CPDMNT	cổ phần dệt may nha trang
CPDNT	cổ phần doanh nghiệp trẻ
CPDVBV	cổ phần dịch vụ bảo vệ
CPDVDL	cổ phần dịch vụ du lịch
CPDVDLĐL	cổ phần dịch vụ du lịch đà lạt
CPHH	cổ phần hàng hải
CPHT	cà phê hòa tan
CPITN	cổ phần in thái nguyên
CPKSPT	cổ phần khách sạn phan thiết
CPKTXD	cổ phần kiến trúc xây dựng
CPPTCN	cổ phần phát triển công nghệ
CPPTNN	cổ phần phát triển nông nghiệp
CPQT	công pháp quốc tế
CPSH	chế phẩm sinh học
CPTB	cổ phần thiết bị
CPTBD	cổ phần thái bình dương
CPTCCG	cổ phần thi công cơ giới
CPTM	cổ phần thương mại
CPTMMN	cổ phần thương mại miền núi
CPTN	cà phê trung nguyên
CPTP	cầu phà thành phố
CPTS	cổ phần thủy sản
CPTVXDVCN	cổ phần tư vấn xây dựng và công nghệ
CPTĐ	cổ phần thủy điện
CPVT	cổ phần vận tải
CPXD	cổ phần xây dựng
CPXDCT	cổ phần xây dựng công trình
CPXDCTGT	cổ phần xây dựng công trình giao thông
CPXDLS	cổ phần xây dựng lạng sơn
CPXL	cổ phần xây lắp
CPXNK	cổ phần xuất nhập khẩu
CPĐOSG	cổ phần địa ốc sài gòn
CPĐT	chính phủ điện tử
CPĐTPT	cổ phần đầu tư phát triển
CPĐTTM	cổ phần đầu tư thương mại
CPĐTXD	cổ phần đầu tư xây dựng
CPƯĐ	cổ phần ưu đãi
CQCA	cơ quan công an
CQCSĐT	cơ quan cảnh sát điều tra
CQLD	cục quản lý dược
CQLG	cục quản lý giá
CQNN	cơ quan nhà nước
CQSDĐ	chuyển quyền sử dụng đất
CQTT	
CQĐD	cơ quan đại diện
CQĐT	cơ quan điều tra
CQĐV	cơ quan đơn vị
CSBV	cảnh sát bảo vệ
CSBVN	cảnh sát biển việt nam
CSCC	chiếu sáng công cộng
CSCN	chữ số có nghĩa
CSCĐ	cảnh sát cơ động
CSDL	cơ sở dữ liệu
CSDN	cơ sở doanh nghiệp
CSGD	cơ sở giáo dục
CSGMGC	cơ sở giết mổ gia cầm
CSGT	cảnh sát giao thông
CSGTTT	cảnh sát giao thông trật tự
CSGTĐT	cảnh sát giao thông đường thủy
CSHCM	cộng sản hồ chí minh
CSHS	cảnh sát hình sự
CSHSĐN	cảnh sát hình sự đặc nhiệm
CSHT	cơ sở hạ tầng
CSKD	cơ sở kinh doanh
CSKDCD	cơ sở kinh doanh cấp dưỡng
CSKH	chăm sóc khách hàng
CSKT	cảnh sát kinh tế
CSKTXH	chính sách kinh tế xã hội
CSKV	cảnh sát khu vực
CSMT	cảnh sát môi trường
CSND	cảnh sát nhân dân
CSPCCC	cảnh sát phòng cháy chữa cháy
CSPCMT	cảnh sát phòng chống ma túy
CSQLHC	cảnh sát quản lý hành chính
CSSK	chăm sóc sức khỏe
CSSX	cơ sở sản xuất
CSSXNT	cơ sở sản xuất nước tương
CSTE	chăm sóc trẻ em
CSTHN	chung sống trước hôn nhân
CSTN	cao su thiên nhiên
CSTP	cảnh sát tư pháp
CSTQ	cộng sản trung quốc
CSTT	chính sách tiền tệ
CSTĐ	cao su tiểu điền
CSVC	cơ sở vật chất
CSVL	cao su việt lào
CSVN	cộng sản việt nam
CSXH	chính sách xã hội
CSXK	cao sản xuất khẩu
CSĐN	cảnh sát đặc nhiệm
CSĐT	cảnh sát điều tra
CSĐTBT	cảnh sát điều tra bình thuận
CSĐTPN	cảnh sát điều tra phía nam
CSĐTTP	cảnh sát điều tra tội phạm
CSĐTTPMT	cảnh sát điều tra tội phạm ma túy
CSĐTTPQLKT	cảnh sát điều tra tội phạm quản lý kinh tế
CSĐTTPTTXH	cảnh sát điều tra tội phạm trật tự xã hội
CSĐTTPVMT	cảnh sát điều tra tội phạm về ma túy
CTBT	chế tạo biến thế
CTCH	chấn thương chỉnh hình
CTCK	công ty chứng khoán
CTCLQG	chương trình chống lao quốc gia
CTCP	công ty cổ phần
CTCPNB	công ty cổ phần nam bộ
CTCPXNKLT	công ty cổ phần xuất nhập khẩu lương thực
CTCS	công ty cao su
CTDCVL	cụm tuyến dân cư vùng lũ
CTGD	chương trình giáo dục
CTGLVH	chương trình giao lưu văn hóa
CTGT	công trình giao thông
CTGTCC	công trình giao thông công chính
CTGĐ	công tác gia đình
CTHCQG	chính trị hành chính quốc gia
CTHCQGHCM	chính trị hành chính quốc gia hồ chí minh
CTHĐQT	chủ tịch hội đồng quản trị
CTKB	cho thuê kho bãi
CTKH	chu trình kết hợp
CTKT	cấu tạo kiến trúc
CTLT	chiến tranh lãnh thổ
CTMP	
CTMT	cấu trúc máy tính
CTNH	chất thải nguy hại
CTNHN	cung thiếu nhi hà nội
CTPB	chương trình phân ban
CTPH	chương trình phối hợp
CTQG	chính trị quốc gia
CTQS	chính trị quân sự
CTSN	chấn thương sọ não
CTTCMR	chương trình tiêm chủng mở rộng
CTTETTVN	cứu trợ trẻ em tàn tật việt nam
CTTG	chính trị thế giới
CTTH	chương trình tiểu học
CTTL	công trình thủy lợi
CTTĐ	công trình thủy điện
CTUB	chủ tịch uỷ ban
CTV	cộng tác viên
CTVN	công thương việt nam
CTXD	công trình xây dựng
CTXH	công tác xã hội
CTXKTS	chương trình xuất khẩu thủy sản
CTYT	chất thải y tế
CTYTNHH	công ty trách nhiệm hữu hạn
CTĐ	chữ thập đỏ
CTĐKH	chữ thập đỏ khánh hòa
CTĐT	chứng từ điện tử
CTĐVN	chữ thập đỏ việt nam
CVBT	công văn báo tử
CVCS	cong vẹo cột sống
CVCX	công viên cây xanh
CVH	cung văn hóa
CVNT	cảng vụ nha trang
CVPM	công viên phần mềm
CVPMQT	công viên phần mềm quang trung
CVTDB	cáp viễn thông dưới biển
CVVH	công viên văn hóa
CVVT	công viên vũ trụ
CVĐ	cuộc vận động
CXT	chất xúc tác
CĐAN	con đường âm nhạc
CĐAT	cộng đồng an toàn
CĐBC	cao đẳng bán công
CĐBT	cánh đồng bất tận
CĐBVN	cục đường bộ việt nam
CĐBĐ	công đoàn bưu điện
CĐBĐBP	công đoàn bộ đội biên phòng
CĐBĐVN	công đoàn bưu điện việt nam
CĐCD	cao đẳng cộng đồng
CĐCKCN	công đoàn các khu công nghiệp
CĐCN	cao đẳng công nghiệp
CĐCNTP	cao đẳng công nghiệp thực phẩm
CĐCNVN	công đoàn công nghiệp việt nam
CĐCP	con đường chinh phục
CĐCS	chế độ chính sách
CĐCSVM	công đoàn cơ sở vững mạnh
CĐCT	công đoàn công thương
CĐCĐ	cao đẳng cộng đồng
CĐDC	chất độc da cam
CĐDL	cao đẳng du lịch
CĐGD	công đoàn giáo dục
CĐGT	chuyển đổi giới tính
CĐGTVT	cao đẳng giao thông vận tải
CĐHN	cộng đồng hải ngoại
CĐKCN	công đoàn khu công nghiệp
CĐKT	cao đẳng kỹ thuật
CĐKTCN	cao đẳng kinh tế công nghiệp
CĐLĐXH	cao đẳng lao động xã hội
CĐMT	cao đẳng mỹ thuật
CĐNH	công đoàn ngân hàng
CĐNHVN	công đoàn ngân hàng việt nam
CĐNN	cơ điện nông nghiệp
CĐNQD	công đoàn ngoài quốc doanh
CĐQP	công đoàn quốc phòng
CĐSKĐA	cao đẳng sân khấu điện ảnh
CĐSL	cổ đông sáng lập
CĐSP	cao đẳng sư phạm
CĐSPKT	cao đẳng sư phạm kỹ thuật
CĐSPMG	cao đẳng sư phạm mẫu giáo
CĐSPNH	cao đẳng sư phạm nhạc họa
CĐSPĐL	cao đẳng sư phạm đà lạt
CĐTS	chẩn đoán trước sinh
CĐTT	cao đẳng tư thục
CĐTƯ	chỉ đạo trung ương
CĐV	cổ động viên
CĐVC	công đoàn viên chức
CĐVCVN	công đoàn viên chức việt nam
CĐVH	cao đẳng văn hóa
CĐVHNT	cao đẳng văn hóa nghệ thuật
CĐVN	cộng đồng việt nam
CĐXD	cao đẳng xây dựng
CĐXDVN	công đoàn xây dựng việt nam
CĐĐB	chỉ đạo đền bù
CĐĐH	cao đẳng đại học
CĐĐS	công đoàn đường sắt
CĐĐSVN	công đoàn đường sắt việt nam
DATC	dự án tài chính
DAXD	dự án xây dựng
DAXDNMNS	dự án xây dựng nhà máy nước sạch
DBKTTV	dự báo khí tượng thủy văn
DBĐV	dự bị động viên
DCCS	dân chủ cơ sở
DCGC	dịch cúm gia cầm
DCND	dân chủ nhân dân
DCQHBN	dân ca quan họ bắc ninh
DCTD	di cư tự do
DCXH	dân chủ xã hội
DCĐN	dân chủ đa nguyên
DDDN	diễn đàn doanh nghiệp
DDNS	diễn đàn nhân sự
DDQG	dinh dưỡng quốc gia
DDTĐC	di dân tái định cư
DDVN	duyên dáng việt nam
DDĐHH	dung dịch điện hoạt hóa
DHBK	đại học bách khoa
DHSVN	du học sinh việt nam
DHTC	du học tại chỗ
DHTV	đại học trà vinh
DKVN	dầu khí việt nam
DLDKPĐ	du lịch dầu khí phương đông
DLHV	dân lập hùng vương
DLKTCN	dân lập kỹ thuật công nghệ
DLNN	du lịch nước ngoài
DLNT	dân lập nội trú
DLTM	du lịch thương mại
DLVN	du lịch viết nam
DMAH	dòng máu anh hùng
DMCT	danh mục công trình
DMVN	dệt may việt nam
DNCM	dâng niềm cảm mến
DNCPH	doanh nghiệp cổ phần hóa
DNDD	doanh nghiệp dân doanh
DNDLĐTCNBK	dạy nghề dân lập đào tạo công nghệ bách khoa
DNGH	dàn nhạc giao hưởng
DNLH	doanh nghiệp lữ hành
DNNN	doanh nghiệp nhà nước
DNNQD	doanh nghiệp ngoài quốc doanh
DNNVV	doanh nghiệp nhỏ và vừa
DNPM	doanh nghiệp phần mềm
DNQĐ	doanh nghiệp quân đội
DNSG	doanh nghiệp sài gòn
DNTN	doanh nghiệp tư nhân
DNTNMT	doanh nghiệp tư nhân minh thịnh
DNTVN	doanh nghiệp trẻ việt nam
DNTƯ	doanh nghiệp trung ương
DNVK	doanh nghiệp việt kiều
DNVN	doanh nghiệp việt nam
DNVT	doanh nghiệp vận tải
DNVVN	doanh nghiệp vừa và nhỏ
DNXK	doanh nghiệp xuất khẩu
DNĐTNN	doanh nghiệp đầu tư nước ngoài
DQTV	dân quân tự vệ
DSCC	dược sĩ cao cấp
DSGD	dân số gia đình
DSGĐ	dân số gia đình
DSGĐTE	dân số gia đình trẻ em
DSKHHGĐ	dân số kế hoạch hóa gia đình
DSPT	dân sự phúc thẩm
DSST	dân sự sơ thẩm
DSTG	di sản thế giới
DSTL	dòng sông trầm lặng
DSTNTG	di sản thiên nhiên thế giới
DSVH	di sản văn hóa
DSVHPVT	di sản văn hóa phi vật thể
DSVHTG	di sản văn hóa thế giới
DTBB	dự trữ bắt buộc
DTDĐ	điện thoại di động
DTHT	dạy thêm học thêm
DTHVN	dân tộc học việt nam
DTLSVH	di tích lịch sử văn hóa
DTNT	dân tộc nội trú
DTNĐ	dự thảo nghị định
DTTBLĐ	dâu tằm tơ bắc lâm đồng
DTTN	điểm thi tốt nghiệp
DTTS	dân tộc thiểu số
DTTSTN	dân tộc thiểu số tây nguyên
DV	dịch vụ
DVBV	dịch vụ bảo vệ
DVCI	dịch vụ công ích
DVDL	dịch vụ du lịch
DVDLĐL	dịch vụ du lịch đà lạt
DVGT	dịch vụ gia tăng
DVKDTH	dịch vụ kinh doanh tổng hợp
DVKTC	dịch vụ kỹ thuật cao
DVLĐ	dịch vụ lao động
DVNH	dịch vụ ngân hàng
DVPTĐT	dịch vụ phát triển đô thị
DVTM	dịch vụ thương mại
DVTMTH	dịch vụ thương mại thanh hóa
DVTT	dịch vụ trực tuyến
DVVH	dịch vụ văn hóa
DVVL	dịch vụ việc làm
DVVLTN	dịch vụ việc làm thanh niên
DVVTCI	dịch vụ viễn thông công ích
DVĐA	diễn viên điện ảnh
DĐ	di động
DĐTM	di động thông minh
GCCN	giai cấp công nhân
GCCNVN	giai cấp công nhân việt nam
GCMND	giấy chứng minh nhân dân
GCNCLCT	giấy chứng nhận chất lượng công trình
GCNKQTS	giấy chứng nhận kết quả tuyển sinh
GCNQSD	giấy chứng nhận quyền sử dụng
GCNQSDĐ	giấy chứng nhận quyền sử dụng đất
GCNQSH	giấy chứng nhận quyền sở hữu
GCNQSĐ	giấy chứng nhận quyền sử dụng
GCNSK	giấy chứng nhận sức khỏe
GCNTNTT	giấy chứng nhận tốt nghiệp tạm thời
GCNTP	giấy chứng nhận tiêm phòng
GCNĐKKD	giấy chứng nhận đăng ký kinh doanh
GCNĐT	giấy chứng nhận đầu tư
GCPM	gia công phần mềm
GCXKPM	gia công xuất khẩu phần mềm
GD&ĐT	giáo dục và đào tạo
GDBĐS	giao dịch bất động sản
GDCD	giáo dục công dân
GDCK	giao dịch chứng khoán
GDCKTPHCM	giao dịch chứng khoán thành phố hồ chí minh
GDCN	giáo dục chuyên nghiệp
GDCĐ	giáo dục cộng đồng
GDDH	giám đốc điều hành
GDDT	giáo dục đào tạo
GDGT	giáo dục giới tính
GDKHQ	giao dịch không hưởng quyền
GDLN	gia đình lục nam
GDLĐ	giao dịch lưu động
GDLĐTVL	giáo dục lao động tạo việc làm
GDLĐXH	giáo dục lao động xã hội
GDMN	giáo dục mầm non
GDQP	giáo dục quốc phòng
GDTC	giáo dục thể chất
GDTH	giáo dục tiểu học
GDTT	giáo dục tập trung
GDTX	giáo dục thường xuyên
GDVL	giao dịch việc làm
GDVN	giáo dục việt nam
GDVĐĐ	giáo dục viên đồng đẳng
GDĐB	giáo dục đặc biệt
GDĐH	giáo dục đại học
GDĐT	giáo dục đào tạo
GGHB	gìn giữ hòa bình
GHPGTNVN	giáo hội phật giáo thống nhất việt nam
GHPGVN	giáo hội phật giáo việt nam
GHPGVNTN	giáo hội phật giáo việt nam thống nhất
GHSQGMT	giống hải sản quốc gia miền trung
GHVN	giao hưởng việt nam
GLMB	giống lợn miền bắc
GMMTĐ	giá mua một thượng đế
GMTĐ	giám mục tử đạo
GNCT	gặp nhau cuối tuần
GNTT	giảm nhẹ thiên tai
GPKD	giấy phép kinh doanh
GPLX	giấy phép lái xe
GPMB	giải phóng mặt bằng
GPMN	giải phóng miền nam
GPNK	giấy phép nhập khẩu
GPSG	giải phóng sài gòn
GPTM	giải phẫu thẩm mỹ
GPXD	giấy phép xây dựng
GPĐC	giấy phép điều chỉnh
GPĐT	giấy phép đầu tư
GQVL	giải quyết việc làm
GRTN	giao rừng tự nhiên
GRTTCC	gây rối trật tự công cộng
GS	giáo sư
GSTS	giáo sư tiến sĩ
GSTSKH	giáo sư tiến sĩ khoa học
GTCC	giao thông công chánh
GTCLVN	giải thưởng chất lượng việt nam
GTCT	giải trí cuối tuần
GTDT	giáo trình điện tử
GTGD	giá trị giao dịch
GTGT	giá trị gia tăng
GTLN	giá trị lớn nhất
GTMT	giãn tĩnh mạch tinh
GTNN	giá trị nhỏ nhất
GTNT	giao thông nông thôn
GTTPM	giới thiệu tác phẩm mới
GTTTĐPT	giải trí truyền thông đa phương tiện
GTVL	giới thiệu việc làm
GTVLTN	giới thiệu việc làm thanh niên
GTVT	giao thông vận tải
GTVTVN	giao thông vận tải việt nam
GTĐB	giao thông đường bộ
GTĐT	giao thông đô thị
GV	giáo viên
GVCH	giáo viên cơ hữu
GVCN	giáo viên chủ nhiệm
GVGĐ	giúp việc gia đình
GVTH	giáo viên tiểu học
GX	giáo xứ
GĐBV	giám đốc bệnh viện
GĐCA	giám đốc công an
GĐCATP	giám đốc công an thành phố
GĐKKD	giấy đăng ký kinh doanh
GĐKT	giám đốc kỹ thuật
GĐNN	giám định nhà nước
GĐNS	giám đốc nhân sự
GĐPY	giám định pháp y
GĐPYTT	giám định pháp y tâm thần
GĐSX	giám đốc sản xuất
GĐTLA	gạch đồng tâm long an
GĐTT	giám đốc trung tâm
GĐVH	gia đình văn hóa
GĐXH	gia đình xã hội
GĐYK	giám định y khoa
GĐYP	giám định y pháp
GĐĐH	giám đốc điều hành
GĐĐT	giám định đầu tư
HAGL	hoàng anh gia lai
HCB	huy chương bạc
HCCB	hội cựu chiến binh
HCCH	hội chứng chuyển hóa
HCDHTT	hội chợ du học trực tuyến
HCGLTM	hội chợ giao lưu thương mại
HCLĐ	huân chương lao động
HCM	hồ chí minh
HCMHS	hội cha mẹ học sinh
HCNN	hành chính nhà nước
HCOCT	hội chứng ống cổ tay
HCPT	hộ chiếu phổ thông
HCQT	hội chợ quốc tế
HCSN	hành chính sự nghiệp
HCSP	hành chính sư phạm
HCTD	hội chữ thập đỏ
HCTH	hành chính tổng hợp
HCTL	hội chợ triển lãm
HCV	huy chương vàng
HCVL	hội chợ việc làm
HCĐV	hội cổ động viên
HDNT	hội đồng nghệ thuật
HDTQ	hoa đức tinh quân
HDV	hướng dẫn viên
HDVC	hợp đồng vận chuyển
HDXL	hợp doanh xây lắp
HDXX	hội đồng xét xử
HHBĐS	hiệp hội bất động sản
HHBĐSNĐVN	hiệp hội bất động sản nhà đất việt nam
HHCHCTN	hóa học các hợp chất thiên nhiên
HHGĐ	hoạch hóa gia đình
HHHV	hoa hậu hoàn vũ
HHHVTG	hoa hậu hoàn vũ thế giới
HHKVGNVN	hiệp hội kho vận giao nhận việt nam
HHLTVN	hiệp hội lương thực việt nam
HHNH	hiệp hội ngân hàng
HHQCVN	hiệp hội quảng cáo việt nam
HHQT	hoa hậu quốc tế
HHTC	hiệp hội trái cây
HHTCVN	hiệp hội trái cây việt nam
HHTG	hoa hậu thế giới
HHTGNV	hoa hậu thế giới người việt
HHTM	huyết học truyền máu
HHTMTU	huyết học truyền máu trung ương
HHTMTƯ	huyết học truyền máu trung ương
HHTĐ	hoa hậu trái đất
HHVN	hoa hậu việt nam
HHVT	hàng hóa vật tư
HHĐH	hoạt hóa điện hóa
HKCC	hành khách cuối cùng
HKDD	hàng không dân dụng
HKDDVN	hàng không dân dụng việt nam
HKGR	hàng không giá rẻ
HKHKT	hội khoa học kỹ thuật
HKKG	hàng không không gian
HKMT	hàng không miền trung
HKPĐ	hội khỏe phù đổng
HKQT	hàng không quốc tế
HKTT	hộ khẩu thường trú
HKVN	hàng không việt nam
HLATLĐ	hành lang an toàn lưới điện
HLATLĐCA	hành lang an toàn lưới điện cao áp
HLBV	hành lang bảo vệ
HLHTNVN	hội liên hiệp thanh niên việt nam
HLKH	hàn lâm khoa học
HLQG	huấn luyện quốc gia
HLTDTT	huấn luyện thể dục thể thao
HLTL	hành lang thoát lũ
HLTT	huấn luyện thể thao
HLTTQG	huấn luyện thể thao quốc gia
HLV	huấn luyện viên
HLVC	hành lang vận chuyển
HLVQG	huấn luyện viên quốc gia
HMNĐ	hiến máu nhân đạo
HMRBL	hạt mưa rơi bao lâu
HMTD	hạn mức tín dụng
HMTN	hiến máu tình nguyện
HMTT	hậu môn trực tràng
HNB	hội nhà báo
HNBVN	hội nhà báo việt nam
HNCC	hội nghị cấp cao
HNDN	hướng nghiệp dạy nghề
HNGĐ	hôn nhân gia đình
HNHL	hoàn nhan hồng liệt
HNLQT	hãy nói lời quen tôi
HNQG	hạng nhất quốc gia
HNVVN	hội nhà văn việt nam
HNYDTN	hành nghề y dược tư nhân
HPGP	hãng phim giải phóng
HPHN	hòa phát hà nội
HPNN	hãng phim nhà nước
HPNT	hoàng phủ ngọc tường
HPTVN	hãng phim truyện việt nam
HQCK	hải quan cửa khẩu
HQHP	hải quan hải phòng
HQLA	hải quân long an
HQTCT	hoa quả thúc chín tố
HQTP	hải quan thành phố
HQĐT	hải quan điện tử
HS	học sinh
HSCB	học sinh cao bằng
HSCC	hồi sức cấp cứu
HSD	hạn sử dụng
HSDT	hồ sơ dự thầu
HSG	học sinh giỏi
HSGQG	học sinh giỏi quốc gia
HSKT	học sinh kiệm tân
HSMT	hồ sơ mời thầu
HSPT	học sinh phổ thông
HSST	hình sự sơ thẩm
HSSV	học sinh sinh viên
HSV	hội sinh viên
HSVVN	hội sinh viên việt nam
HSXC	hồ sơ xuất cảnh
HSĐK	hồ sơ đăng ký
HSĐKDT	hồ sơ đăng ký dự thi
HSĐN	hình sự đặc nhiệm
HTBS	hưu trí bổ sung
HTCC	hệ thống chấm công
HTCHĐPC	hỗ trợ các hoạt động phòng chống
HTCK	hạch toán chiết khấu
HTCS	hạ tầng cơ sở
HTKT	hổ trợ kỹ thuật
HTLĐ	hợp tác lao động
HTMHQGVN	hội tim mạch học quốc gia việt nam
HTMS	hưu trí mất sức
HTMT	hội thánh miền tây
HTPL	hỗ trợ pháp lý
HTPT	hỗ trợ phát triển
HTQLCL	hệ thống quản lý chất lượng
HTQT	hợp tác quốc tế
HTTH	hợp tuyển thần học
HTTL	hội thánh tin lành
HTTĐ	hệ thống tự động
HTVH	hành trình văn hóa
HTX	hợp tác xã
HTXDVNN	hợp tác xã dịch vụ nông nghiệp
HTXH	hạ tầng xã hội
HTXLNT	hệ thống xử lý nước thải
HTXNN	hợp tác xã nông nghiệp
HTXP	hình thức xử phạt
HTXVTTL	hợp tác xã vận tải thăng long
HTĐĐ	huyền thoại đương đại
HV	học viên
HVBC	học viện báo chí
HVCH	học viên cao học
HVCNTTĐL	học viện công nghiệp thông tin đài loan
HVHCQG	học viện hành chính quốc gia
HVKHQS	học viện khoa học quân sự
HVLQ	học viện lục quân
HVNCLC	hàng việt nam chất lượng cao
HVNH	học viện ngân hàng
HVQHQT	học viện quan hệ quốc tế
HVTC	học viện tài chính
HVTTN	học viện thanh thiếu niên
HĐ	hội đồng
HĐBA	hội đồng bảo an
HĐBALHQ	hội đồng bảo an liên hợp quốc
HĐBC	hội đồng bầu cử
HĐBHNT	hợp đồng bảo hiểm nhân thọ
HĐBT	hội đồng bộ trưởng
HĐBTHT	hội đồng bồi thường hỗ trợ
HĐBĐG	hội đồng bán đấu giá
HĐCD	hội đồng chức danh
HĐCDGSCS	hội đồng chức danh giáo sư cơ sở
HĐCDGSN	hội đồng chức danh giáo sư ngành
HĐCDGSNN	hội đồng chức danh giáo sư nhà nước
HĐCK	hội đồng chung khảo
HĐCM	hội đồng chuyên môn
HĐCN	hợp đồng chuyển nhượng
HĐCT	hội đồng coi thi
HĐDN	hoạt động dã ngoại
HĐDS	hợp đồng dân sự
HĐDT	hội đồng dân tộc
HĐDVPL	hợp đồng dịch vụ pháp lý
HĐGGHB	hoạt động gìn giữ hòa bình
HĐGK	hội đồng giám khảo
HĐGPMB	hội đồng giải phóng mặt bằng
HĐGS	hội đồng giám sát
HĐGT	hội đồng gia tộc
HĐGTGT	hóa đơn giá trị gia tăng
HĐGĐYK	hội đồng giám định y khoa
HĐH	hệ điều hành
HĐHC	hội đồng hương chính
HĐHGCS	hội đồng hòa giải cơ sở
HĐHN	hợp đồng hôn nhân
HĐHTT	hiện đại hóa thông tin
HĐKC	hoạt động kháng chiến
HĐKH	hội đồng khoa học
HĐKL	hội đồng kỷ luật
HĐKT	hợp đồng kinh tế
HĐKTQH	hội đồng kiến trúc quy hoạch
HĐLB	hội đồng liên bang
HĐLĐ	hợp đồng lao động
HĐMBTB	hợp đồng mua bán thiết bị
HĐMC	hẹp động mạch cảnh
HĐND	hội đồng nhân dân
HĐNDTP	hội đồng nhân dân thành phố
HĐNDTPHCM	hội đồng nhân dân thành phố hồ chí minh
HĐNN	hội đồng nhà nước
HĐNT	hội đồng nghệ thuật
HĐNTNN	hội đồng nghiệm thu nhà nước
HĐQG	hội đồng quốc gia
HĐQGGD	hội đồng quốc gia giáo dục
HĐQL	hội đồng quản lý
HĐQPAN	hội đồng quốc phòng an ninh
HĐQT	hội đồng quản trị
HĐSC	hợp đồng sửa chữa
HĐSK	hoạt động sáng kiến
HĐTC	hợp đồng thế chấp
HĐTD	hợp đồng tín dụng
HĐTH	hỏi đáp tin học
HĐTM	hiệp định thương mại
HĐTP	hội đồng thẩm phán
HĐTR	hợp đồng trồng rừng
HĐTS	hội đồng trị sự
HĐTT	hội đồng trọng tài
HĐTTCC	hội đồng thi tuyển công chức
HĐTTQG	hội đồng trọng tài quốc gia
HĐTV	hội đồng tư vấn
HĐTĐ	hội đồng thẩm định
HĐTĐKT	hội đồng thi đua khen thưởng
HĐUT	hợp động ủy thác
HĐVB	hội đồng văn bằng
HĐVC	hợp đồng vận chuyển
HĐXLTNVC	hội đồng xử lý trách nhiệm vật chất
HĐXX	hội đồng xét xử
HĐĐB	hội đồng đền bù
HĐĐG	hội đồng định giá
HĐĐT	hội đồng đấu thầu
HĐĐTLCNĐT	hội đồng đấu thầu lựa chọn nhà đầu tư
HĐĐTĐ	hội đồng đặt tên đường
IOT	ai ô tê
KBNN	kho bạc nhà nước
KBTB	khu bảo tồn biển
KBTTN	khu bảo tồn thiên nhiên
KCB	khám chữa bệnh
KCBMP	khám chữa bệnh miễn phí
KCBT	khoan cắt bê tông
KCHTLH	kiên cố hóa trường lớp học
KCHTĐS	kết cấu hạ tầng đường sắt
KCN	khu công nghiệp
KCNC	khu công nghệ cao
KCNDV	khu công nghiệp dịch vụ
KCNHP	khu công nghiệp hiệp phước
KCNTL	khu công nghiệp thăng long
KCNĐN	khu công nghiệp đồng nai
KCX	khu chế xuất
KDBH	kinh doanh bảo hiểm
KDBĐS	kinh doanh bất động sản
KDC	khu dân cư
KDCK	kinh doanh chứng khoán
KDDV	kiểm dịch động vật
KDL	khu du lịch
KDLBCR	khu du lịch bắc cam ranh
KDLSL	khu du lịch sông lô
KDLSTTT	khu du lịch sinh thái thủy tiên
KDLVT	khu du lịch văn thánh
KDNS	kinh doanh nước sạch
KDTH	kết duyên tơ hồng
KDTSQ	khu dự trữ sinh quyển
KDTT	kinh doanh trực tuyến
KDTV	kiểm dịch thực vật
KDXD	kinh doanh xăng dầu
KG	ki lô gam
KGBC	khán giả bình chọn
KGVHCCTN	không gian văn hóa cồng chiêng tây nguyên
KGXCC	không gian xanh công cộng
KH&CN	khoa học và công nghệ
KHCN	khoa học công nghệ
KHCNMT	khoa học công nghệ môi trường
KHCNXD	khoa học công nghệ xây dựng
KHDT	kế hoạch đầu tư
KHGD	khoa học giáo dục
KHHGĐ	kế hoạch hóa gia đình
KHHGĐVN	kế hoạch hóa gia đình việt nam
KHHKKG	khoa học hàng không không gian
KHHS	khoa học hình sự
KHKT	khoa học kỹ thuật
KHKTBHLĐ	khoa học kỹ thuật bảo hộ lao động
KHKTHN	khoa học kỹ thuật hạt nhân
KHKTHS	khoa học kỹ thuật hình sự
KHKTNN	khoa học kỹ thuật nông nghiệp
KHKTTV	khoa học khí tượng thủy văn
KHKTVN	khoa học kỹ thuật vật nuôi
KHLM	khuyến học liên mạng
KHLS	khoa học lịch sử
KHLSVN	khoa học lịch sử việt nam
KHPL	khoa học pháp lý
KHPT	khoa học phổ thông
KHQS	khoa học quân sự
KHTDTT	khoa học thể dục thể thao
KHTH	khoa học tổng hợp
KHTL	khoa học thủy lợi
KHTN	khoa học tự nhiên
KHTT	khách hàng thân thiết
KHVL	khoa học vật liệu
KHVN	khoa học việt nam
KHXB	kế hoạch xuất bản
KHXH	khoa học xã hội
KHXHNV	khoa học xã hội nhân văn
KHXHVN	khoa học xã hội việt nam
KHĐT	kế hoạch đầu tư
KKT	khu kinh tế
KKTCK	khu kinh tế cửa khẩu
KKTM	khu kinh tế mở
KKTNS	khu kinh tế nghi sơn
KKTNT	khuyến khích tài năng trẻ
KKTS	kê khai tài sản
KKTTN	khu kinh tế thanh niên
KKTVP	khu kinh tế vân phong
KLCĐ	kiểm lâm cơ động
KLGD	khối lượng giao dịch
KLGĐ	kết luận giám định
KLHCNDVĐT	khu liên hợp công nghiệp dịch vụ đô thị
KLHCNDVĐTBD	khu liên hợp công nghệ dịch vụ đô thị bình dương
KLHP	kiểm lâm hải phòng
KLHTTQG	khu liên hợp thể thao quốc gia
KLQG	kỷ lục quốc gia
KLTG	kỷ lục thế giới
KLTT	kết luận thanh tra
KLĐT	kết luận điều tra
KNDS	khai nhận di sản
KNHT	khám nghiệm hiện trường
KNKL	khuyến nông khuyến lâm
KNNCNC	khu nông nghiệp công nghệ cao
KNTC	khiếu nại tố cáo
KNXK	kim ngạch xuất khẩu
KPXDN	kinh phí xây dựng nhà
KQLGT	khu quản lý giao thông
KQLGTĐT	khu quản lý giao thông đô thị
KQLĐB	khu quản lí đường bộ
KQXS	kết quả xổ số
KS	kỹ sư
KSBPCK	kiểm soát biên phòng cửa khẩu
KSGM	kiểm soát giết mổ
KSGT	kiểm soát giao thông
KSHS	khảo sát hàm số
KSKH	khách sạn khải hoàn
KSKĐK	khám sức khỏe định kỳ
KSLH	kiểm soát liên hoàn
KSLN	kiểm soát liên ngành
KSND	kiểm sát nhân dân
KSNDTC	kiểm sát nhân dân tối cao
KSTB	kỹ sư trực ban
KSTĐ	ký sự tân đảo
KSXD	kỹ sư xây dựng
KSXX	kiểm sát xét xử
KSXXPT	kiểm sát xét xử phúc thẩm
KSĐN	khách sạn đồng nai
KSĐT	kiểm sát điều tra
KTCK	kinh tế cửa khẩu
KTCN	kỉ thuật công nghiệp
KTCS	kỉ thuật cơ sở
KTCTTL	khai thác công trình thủy lợi
KTGS	kiểm tra giám sát
KTGSLN	kiểm tra giám sát liên ngành
KTGĐ	kiến thức gia đình
KTHS	kỹ thuật hình sự
KTHT	kinh tế hợp tác
KTKL	kiểm tra kỷ luật
KTKLTƯ	kiểm tra kỷ luật trung ương
KTKT	kinh tế kỹ thuật
KTLT	kỹ thuật lập trình
KTMN	kinh thánh mỗi ngày
KTNHT	kho tài nguyên học tập
KTNN	kiểm toán nhà nước
KTNS	kinh tế ngân sách
KTNĐ	kiến trúc nhà đẹp
KTPT	kinh tế phát triển
KTQD	kinh tế quốc dân
KTQG	kế toán quốc gia
KTQP	kinh tế quốc phòng
KTQS	kỹ thuật quân sự
KTQT	kinh tế quốc tế
KTSG	kinh tế sài gòn
KTST	kiến trúc sư trưởng
KTSTQ	kiểm tra sau thông quan
KTSVN	kiến trúc sư việt nam
KTTCĐLCL	kỹ thuật tiêu chuẩn đo lường chất lượng
KTTH	kế toán thực hành
KTTHHN	kỹ thuật tổng hợp hướng nghiệp
KTTM	kinh tế thương mại
KTTMĐB	kinh tế thương mại đặc biệt
KTTN	kinh tế thanh niên
KTTS	khai thác tài sản
KTTT	kinh tế thị trường
KTTV	khí tượng thủy văn
KTTVNB	khí tượng thủy văn nam bộ
KTTVQG	khí tượng thủy văn quốc gia
KTTVTƯ	khí tượng thủy văn trung ương
KTTĐ	kinh tế trọng điểm
KTVA	khởi tố vụ án
KTVH	kinh tế văn hóa
KTVHVN	kinh tế văn hóa việt nam
KTVN	kế toán việt nam
KTVP	kế toán văn phòng
KTX	ký túc xá
KTXB	khai thác xa bờ
KTXD	kinh tế xây dựng
KTXH	kinh tế xã hội
KTĐC	khu tai định cư
KTĐN	kinh tế đối ngoại
KTĐT	kiến trúc đô thị
KTĐĐ	khai thác điểm đỗ
KTĐĐX	khai thác điểm đỗ xe
KVCGT	khu vui chơi giải trí
KVHGĐ	khu văn hóa gia đình
KVPN	khu vực phía nam
KVTS	khu vực tuyển sinh
KW	kí lô quát
KĐCL	kiểm định chất lượng
KĐCLGD	kiểm định chất lượng giáo dục
KĐT	khu đô thị
KĐTM	khu đô thị mới
KĐTMNSCT	khu đô thị mới nam sông cần thơ
KĐTMTT	khu đô thị mới thủ thiêm
KĐTVV	khu đô thị vui vẻ
LCDB	lao công đào binh
LCHH	lưu chuyển hàng hóa
LCNPMA	làng công nghệ phần mềm ảo
LCTA	lê công tuấn anh
LDXD	liên doanh xây dựng
LGQT	lễ giỗ quốc tổ
LGT	luật giao thông
LHCHVHNT	liên hiệp các hội văn học nghệ thuật
LHCTCHN	liên hiệp các tổ chức hữu nghị
LHCĐ	liên hiệp công đoàn
LHHTXTM	liên hiệp hợp tác xã thương mại
LHKHKT	liên hiệp khoa học kỹ thuật
LHP	liên hoan phim
LHPN	liên hiệp phụ nữ
LHPNVN	liên hiệp phụ nữ việt nam
LHPQT	liên hoan phim quốc tế
LHPVN	liên hoan phim việt nam
LHSVN	lưu học sinh việt nam
LHTHTQ	liên hoan truyền hình toàn quốc
LHTN	liên hiệp thanh niên
LHTNSV	liên hoan thanh niên sinh viên
LHTNVN	liên hiệp thanh niên việt nam
LHTT	lễ hội truyền thống
LHTTQG	liên hợp thể thao quốc gia
LHĐSVN	liên hiệp đường sắt việt nam
LKCK	lưu ký chứng khoán
LKDBH	luật kinh doanh bảo hiểm
LKTĐ	liên kết thi đua
LLLĐ	lực lượng lao động
LLPB	lý luận phê bình
LLVH	lý luận văn học
LLVT	lực lượng vũ trang
LLVTND	lực lượng vũ trang nhân dân
LMDC	liên minh dân chủ
LMLM	lở mồm long móng
LMĐN	lắp máy điện nước
LPCB	lạm phát cơ bản
LPCBLTGĐ	luật phòng chống bạo lực trong gia đình
LPCCBTN	luật phòng chống các bệnh truyền nhiễm
LPTB	lệ phí trước bạ
LQTT	lê quang thanh tâm
LSQ	lãnh sự quán
LSQS	lịch sử quân sự
LSQSVN	lịch sử quân sự việt nam
LSTDĐT	lãi suất tín dụng đầu tư
LSTN	lương sơn thủy nguyên
LSVH	lịch sử văn hóa
LSVN	lịch sử việt nam
LTBTT	lương thực bình trị thiên
LTLT	linh ta linh tinh
LTMN	lương thực miền nam
LTNLN	làng thanh niên lập nghiệp
LTQG	lưu trữ quốc gia
LTQĐTD	lây truyền qua đường tình dục
LTTC	lý thuyết trò chơi
LTTHS	luật tố tụng hình sự
LTTP	lương thực thực phẩm
LTTT	lý thuyết truyền tin
LVSĐN	lưu vực sông đồng nai
LĐBB	liên đoàn bóng bàn
LĐBC	liên đoàn bóng chuyền
LĐBCVN	liên đoàn bóng chuyền việt nam
LĐBR	liên đoàn bóng rổ
LĐBT	liên đoàn bóng tròn
LĐBĐ	liên đoàn bóng đá
LĐBĐLA	liên đoàn bóng đá long an
LĐBĐQG	liên đoàn bóng đá quốc gia
LĐBĐTH	liên đoàn bóng đá thanh hóa
LĐBĐTPHCM	liên đoàn bóng đá thành phố hồ chí minh
LĐBĐVN	liên đoàn bóng đá việt nam
LĐCL	liên đoàn cầu lông
LĐCN	lắp đặt công nghệ
LĐCS	lao động chính sách
LĐCT	lôi động cửu thiên
LĐCĐ	lừa đảo chiếm đoạt
LĐDTTS	lao động dân tộc thiểu số
LĐHN	lao động hữu nghị
LĐKBĐS	luật đăng ký bất động sản
LĐLD	liên đoàn lao động
LĐLĐ	liên đoàn lao động
LĐLĐTP	liên đoàn lao động thành phố
LĐLĐVN	liên đoàn lao động việt nam
LĐNC	lao động nhập cư
LĐNN	lao động nước ngoài
LĐNT	lao động nông thôn
LĐPT	lao động phổ thông
LĐQP	lao động quốc phòng
LĐQV	liên đoàn quần vợt
LĐQVVN	liên đoàn quần vợt việt nam
LĐST	lao động sáng tạo
LĐSX	lao động sản xuất
LĐTB	lao động thương binh
LĐTB&XH	lao động thương binh và xã hội
LĐTBXH	lao động thương binh xã hội
LĐTC	luật đầu tư chung
LĐTD	lao động tự do
LĐTNDC	liên đoàn thanh niên dân chủ
LĐTNDCTG	liên đoàn thanh niên dân chủ thế giới
LĐTT	liên đoàn thể thao
LĐTTĐNA	liên đoàn thể thao đông nam á
LĐVL	lao động việc làm
LĐVN	lao động việt nam
LĐXH	lao động xã hội
LĐXHTP	lao động xã hội thành phố
LĐXK	lao động xuất khẩu
LĐXS	lao động sản xuất
LĐXĐ	liên đoàn xe đạp
LĐĐC	liên đoàn đá cầu
LĐĐK	liên đoàn điền kinh
LĐĐKVN	liên đoàn điền kinh việt nam
LĐĐT	lao động điện tử
MACĐ	mái ấm công đoàn
MBDB	một buổi đi bơi
MBHTĐ	máy bán hàng tự động
MBQH	mặt bằng quy hoạch
MDCT	mức độ cạnh tranh
MGCK	môi giới chứng khoán
MGHN	môi giới hôn nhân
MGMN	mẫu giáo mầm non
MHAV	mai hoa ảnh viện
MHQL	mô hình quản lý
MHTNTN	mùa hè thanh niên tình nguyện
MHX	mùa hè xanh
MLCT	minh lương cẩm tú
MLSS	mã lực so sánh
MNBC	mầm non bán công
MNCV	mầm non cẩm vân
MNDBT	mực nước dâng bình thường
MNTT	mầm non tư thục
MPQT	mỹ phẩm quốc tế
MSLĐ	mất sức lao động
MSMV	mã số mã vạch
MSVT	mã số vật tư
MTCN	mỹ thuật công nghiệp
MTDTGP	mặt trận dân tộc giải phóng
MTDTGPMNVN	mặt trận dân tộc giải phóng miền nam việt nam
MTDTTN	mặt trận dân tộc thống nhất
MTGP	mặt trận giải phóng
MTGPMN	mặt trận giải phóng miền nam
MTKC	mặt trận kháng chiến
MTLD	môi trường lao động
MTLĐ	môi trường lao động
MTQT	má tớ quát thế
MTTG	môi trường thế giới
MTTH	ma túy tổng hợp
MTTN	máu tụ trong não
MTTP	mĩ thuật thành phố
MTTQ	mặt trận tổ quốc
MTTQVN	mặt trận tổ quốc việt nam
MTXT	máy tính xách tay
MTĐB	máy tính để bàn
MTĐH	mục tiêu đại hội
MTĐT	môi trường đô thị
MTĐĐ	mỹ thuật đương đại
MXNB	mùa xuân nhớ bác
MĐLN	mía đường la ngà
NAVN	nhiếp ảnh việt nam
NBCT	nỗi buồn chiến tranh
NBVN	nhà báo việt nam
NCCB	nghiên cứu cơ bản
NCCDV	nhà cung cấp dịch vụ
NCCL	nâng cao chất lượng
NCCVCM	người có công với cách mạng
NCGCD	những cô gái chân dài
NCHS	nghiên cứu hải sản
NCKH	nghiên cứu khoa học
NCKHKT	nghiên cứu khoa học kỹ thuật
NCKT	ngõ chợ khâm thiên
NCLTG	những chiếc lá thời gian
NCQLKT	nghiên cứu quản lý kinh tế
NCTNCN	nghiên cứu tiềm năng con người
NCTT	nghiên cứu thị trường
NCUNLCC	nhà cung ứng nhân lực cao cấp
NCXH	nghiên cứu xã hội
NCĐĐ	nghiên cứu đà điểu
NDCM	nhân dân cách mạng
NDGĐ	nhân dân gia định
NDNB	nhiệt điện ninh bình
NDND	nghệ sĩ nhân dân
NDTC	nhân dân tối cao
NDTP	nhân dân thành phố
NDTQ	nhân dân tự quản
NDTTS	người dân tộc thiểu số
NDVN	nông dân việt nam
NGND	nhà giáo nhân dân
NGTT	người giới thiệu thuốc
NHCP	ngân hàng cổ phần
NHCPTM	ngân hàng cổ phần thương mại
NHCSXH	ngân hàng chính sách xã hội
NHCSXHVN	ngân hàng chính sách xã hội việt nam
NHCT	ngân hàng công thương
NHCTVN	ngân hàng công thương việt nam
NHDA	ngân hàng đông á
NHHH	nhãn hiệu hàng hóa
NHKVN	nhà hát kịch việt nam
NHLD	ngân hàng liên doanh
NHM	người hâm mộ
NHNN	ngân hàng nhà nước
NHNNPTNT	ngân hàng nông nghiệp phát triển nông thôn
NHNNVN	ngân hàng nhà nước việt nam
NHNT	ngân hàng ngoại thương
NHPT	ngân hàng phát triển
NHPTVN	ngân hàng phát triển việt nam
NHQD	ngân hàng quốc doanh
NHTG	ngân hàng thế giới
NHTM	ngân hàng thương mại
NHTMCP	ngân hàng thương mại cổ phần
NHTMNN	ngân hàng thương mại nhà nước
NHTMQD	ngân hàng thương mại quốc doanh
NHTT	nhà hát tuổi trẻ
NHTTĐ	năm hành tinh trái đất
NHTW	ngân hàng trung ương
NHTƯ	ngân hàng trung ương
NHVN	ngân hàng việt nam
NHXN	ngân hàng xác nhận
NHĐA	ngân hàng đông á
NHĐT	ngân hàng đề thi
NK	nhập khẩu
NKBV	nhiễm khuẩn bệnh viện
NKHHCT	nhiễm khuẩn hô hấp cấp tính
NKKN	nam kỳ khởi nghĩa
NKTS	nhật kí tâm sự
NKXD	nhập khẩu xăng dầu
NKĐT	nhiễm khuẩn đường tiểu
NLCX	năng lượng cảm xạ
NLCXH	năng lượng cảm xạ học
NLD	người lao động
NLGMN	nguyên liệu giấy miền nam
NLMT	năng lượng mặt trời
NLN	nông lâm nghiệp
NLNT	năng lương nguyên tử
NLNTVN	năng lượng nguyên tử việt nam
NLSH	nhiên liệu sinh học
NLTQD	nông lâm trường quốc doanh
NLTS	nguồn lợi thủy sản
NLTT	năng lượng tái tạo
NLVN	nhân lực việt nam
NLĐ	người lao động
NLĐCTN	người lao động chưa thành niên
NLĐVN	người lao động việt nam
NMCBMCS	nhà máy chế biến mủ cao su
NMCBTS	nhà máy chế biến thủy sản
NMCT	nhồi máu cơ tim
NMDMK	nhà máy dệt minh khai
NMITQG	nhà máy in tiền quốc gia
NMLD	nhà máy lọc dầu
NMLDDQ	nhà máy lọc dầu dung quất
NMNTH	nhà máy nước tân hiệp
NMNĐ	nhà máy nhiệt điện
NMPLHR	nhà máy phân lân hàm rồng
NMTH	nhà máy tân hiệp
NMTL	người mỹ trầm lặng
NMTĐ	nhà máy thủy điện
NMXLNT	nhà máy xử lý nước thải
NMXLNTTT	nhà máy xử lý nước thải tập trung
NMXLR	nhà máy xử lý rác
NMXM	nhà máy xi măng
NMXXTB	nhà máy xay xát thái bình
NMĐCR	nhà máy đường cam ranh
NMĐNT	nhà máy điện nguyên tử
NMĐQN	nhà máy đường quảng nam
NMĐT	nhà máy đóng tàu
NNBA	ngôi nhà bí ẩn
NNCT	ngôn ngữ cơ thể
NNCĐDC	nạn nhân chất độc da cam
NNCĐMDC	nạn nhân chất độc màu da cam
NNDC	nạn nhân da cam
NNKTC	nông nghiệp kỹ thuật cao
NNNT	ngành nghề nông thôn
NNPL	nhà nước pháp luật
NNPT	nông nghiệp phát triển
NNPTNT	nông nghiệp phát triển nông thôn
NNTƯ	nông nghiệp trung ương
NNVN	nông nghiệp việt nam
NNĐC	nông nghiệp địa chính
NNĐP	nhà nước địa phương
NNĐTVV	những người độc thân vui vẻ
NOCV	nhà ở công vụ
NOXH	nhà ở xã hội
NPTT	ngân phiếu thanh toán
NQ/TW	nghị quyết trung ương
NQLG	nhà quản lý giỏi
NQLT	nghị quyết liên tịch
NQTM	nhượng quyền thương mại
NQTƯ	nghị quyết trung ương
NQĐH	nghị quyết đại hội
NSDLD	người sử dụng lao động
NSDLĐ	người sử dụng lao động
NSLĐ	năng suất lao động
NSNA	nghệ sĩ nhiếp ảnh
NSNAVN	nghệ sĩ nhiếp ảnh việt nam
NSND	nghệ sĩ nhân dân
NSNN	ngân sách nhà nước
NSSK	nghệ sĩ sân khấu
NSSKVN	nghệ sĩ sân khấu việt nam
NSTP	nông sản thực phẩm
NSTTN	nhà sưu tập tư nhân
NSUT	nghệ sĩ ưu tú
NSVHCN	nếp sống văn hóa công nghiệp
NSVMĐT	nếp sống văn minh đô thị
NSVN	nguyệt san việt nam
NSVSMT	nước sạch vệ sinh môi trường
NSX	nhà sản xuất
NSĐP	ngân sách địa phương
NSƯT	nghệ sĩ ưu tú
NTBD	nghệ thuật biểu diễn
NTBV	nhà thuốc bệnh viện
NTD	người tiêu dùng
NTDM	nhiễm trùng đường mật
NTGT	nhà thuốc gia truyền
NTHH	nguyên tố hóa học
NTHM	nguyễn thị hồng minh
NTKN	ngừng thở khi ngủ
NTKTT	nhà thiết kế thời trang
NTLS	nghĩa trang liệt sĩ
NTLSTP	nghĩa trang liệt sĩ thành phố
NTMK	nguyễn thị minh khai
NTNN	nông thôn ngày nay
NTQĐ	nghĩa trang quân đội
NTTC	nuôi tôm trên cát
NTTS	nuôi trồng thủy sản
NTVN	ngoại thương việt nam
NTVT	người tốt việt tốt
NTĐ	nhà thi đấu
NTĐYGT	nhà thuốc đông y gia truyền
NTĐĐ	nghệ thuật đương đại
NVBĐD	nhiệm vụ bất đắc dĩ
NVCA	nhà văn công an
NVGC	nhân viên gác chắn
NVH	nhà văn hóa
NVHC	nhân viên hành chính
NVHCC	nghiệp vụ hành chính công
NVHLĐ	nhà văn hóa lao động
NVHN	nhà văn hoài nam
NVHTN	nhà văn hóa thanh niên
NVKD	nhân viên kinh doanh
NVKVN	nhạc vũ kịch việt nam
NVNONN	người việt nam ở nước ngoài
NVPH	nhân viên phi hành
NVQG	người việt quốc gia
NVQL	nhân viên quản lý
NVQS	nghĩa vụ quân sự
NVS	nhà vệ sinh
NVSCC	nhà vệ sinh công cộng
NVTV	nhân viên tư vấn
NVTVBS	nhân viên tư vấn bổ sung
NVVN	người việt về nguồn
NXB	nhà xuất bản
NXBCTQG	nhà xuất bản chính trị quốc gia
NXBGD	nhà xuất bản giáo dục
NXBT	nhà xuất bản trẻ
NXBTN	nhà xuất bản thanh niên
NXDKP	nạn xây dựng không phép
NĐ	nghị định
NĐCBVTS	những điều cần biết về tuyển sinh
NĐNB	nhiệt điện ninh bình
NĐT	nhà đầu tư
NĐTB	nhiệt độ trung bình
NĐTNN	nhà đầu tư nước ngoài
NĐTP	ngộ độc thực phẩm
NĐTTN	nhà đầu tư trong nước
NĐVN	người đẹp việt nam
ONKQ	ống nội khí quản
PABT	phương án bồi thường
PAĐM	phương án đổi mới
PBGDPL	phổ biến giáo dục pháp luật
PBTL	phủ biên tạp lục
PBTTU	phó bí thư thành uỷ
PBVH	phê bình văn học
PCBD	phòng chống bệnh dại
PCBL	phòng chống bão lụt
PCCC	phòng cháy chữa cháy
PCCCR	phòng cháy chữa cháy rừng
PCCN	phòng chống cháy nổ
PCCR	phòng chống cháy rừng
PCDC	phòng chống dịch cúm
PCDCGC	phòng chống dịch cúm gia cầm
PCGD	phổ cập giáo dục
PCGDBTH	phổ cập giáo dục bậc trung học
PCGDTH	phổ cập giáo dục tiểu học
PCLB	phòng chống lụt bão
PCLBMN	phòng chống lụt bão miền nam
PCLBTƯ	phòng chống lụt bão trung ương
PCMT	phần cứng máy tính
PCSR	phòng chống sốt rét
PCT	phó chủ tịch
PCTH	phổ cập tiểu học
PCTHCS	phổ cập trung học cơ sở
PCTHTL	phòng chống tác hại thuốc lá
PCTN	phòng chống tham nhũng
PCTNXH	phòng chống tệ nạn xã hội
PCTPCNC	phòng chống tội phạm công nghệ cao
PCTPMT	phòng chống tội phạm ma túy
PCTVCA	phòng chống thương vong châu á
PCVT	phi công vũ trụ
PGCM	phân giới cắm mốc
PGDVL	phiên giao dịch việc làm
PGS	phó giáo sư
PGSTS	phó giáo sư tiến sĩ
PGTP	phụ gia thực phẩm
PGVN	phật giáo việt nam
PGĐ	phó giám đốc
PHBC	phát hành báo chí
PHCN	phục hồi chức năng
PHHS	phụ huynh học sinh
PHKQ	phát hành kho quỹ
PHPT	phật học phổ thông
PHQC	phác họa quảng cáo
PKKQ	phòng không không quân
PKKV	phòng khám khu vực
PKTN	phòng khám tư nhân
PKĐK	phòng khám đa khoa
PLCTRTN	phân loại chất thải rắn từ nguồn
PLDSKT	pháp luật dân sự kinh tế
PLHĐ	phụ lục hợp đồng
PLRTN	phân loại rác tại nguồn
PLTTNC	pháp lệnh thuế thu nhập cao
PMDC	phần mềm dùng chung
PMH	phú mỹ hưng
PMNM	phần mềm nguồn mở
PMNĐ	phần mềm nội địa
PMST	phần mềm sáng tạo
PMTD	phần mềm tự do
PMVN	phần mềm việt nam
PNCL	phòng nghiên cứu lịch
PNCT	phụ nữ có thai
PNKB	phong nha kẻ bàng
PNMD	phụ nữ mại dâm
PNTE	phụ nữ trẻ em
PNTP	phụ nữ việt thành phố
PNVN	phụ nữ việt nam
PPDA	phương pháp dự án
PPDH	phương pháp dạy học
PRCR	phòng ruồi chống ruồi
PSDN	phá sản doanh nghiệp
PSPT	phát sóng phát thanh
PTCS	phổ thông cơ sở
PTCT	phát triển chương trình
PTCĐ	phát triển cộng đồng
PTDL	phổ thông dân lập
PTDS	phúc thẩm dân sự
PTDT	phổ thông dân tộc
PTDTNT	phổ thông dân tộc nội trú
PTGD	phó tổng giám đốc
PTGMHS	phẫu thuật gây mê hồi sức
PTGVTH	phát triển giáo viên tiểu học
PTGĐ	phó tổng giám đốc
PTHH	phần tử hữu hạn
PTHTCKCN	phát triển hạ tầng các khu công nghiệp
PTKS	phát triển khoáng sản
PTKT	phân tích kỹ thuật
PTKTXD	phát triển kỹ thuật xây dựng
PTLL	phát triển lây lan
PTNB	phú thịnh nhà bè
PTNBT	phát triển nhà bình thạnh
PTNK	phổ thông năng khiếu
PTNN	phương trình nghiệm nguyên
PTNT	phát triển nông thôn
PTNTVN	phát triển nông thôn việt nam
PTNTĐ	phòng thí nghiệm trọng điểm
PTPM	phát triển phần mềm
PTPT	phiên tòa phúc thẩm
PTS	phó tiến sĩ
PTTH	phổ thông trung học
PTTHDL	phổ thông trung học dân lập
PTTHTT	phổ thông trung học tự túc
PTTM	phẫu thuật thẩm mỹ
PTTN	phòng thu tư nhân
PTTNĐ	phương tiện thủy nội địa
PTTT	phát triển thị trường
PTVMĐT	phát triển văn minh đô thị
PTVN	phim truyện việt nam
PTXD	phế thải xây dựng
PTĐT	phát triển đô thị
PV	phóng viên
PVBC	phân viện báo chí
PVBCTT	phân viện báo chí tuyên truyền
PVKT	phân vùng kinh tế
PVLĐ	phóng viên lao động
PVSHĐL	phân viện sinh học đà lạt
PVTS	phóng viên tập sự
PVTT	phỏng vấn truyền thống
PVXH	phóng viên xã hội
PVĐT	phóng viên điều tra
PĐTBS	phình đại tràng bẩm sinh
QBQT	quà biếu quà tặng
QC	quảng cáo
QCATM	quảng cáo ảnh thương mại
QCCTNB	quy chế chi tiêu nội bộ
QCDC	quy chế dân chủ
QCHQ	quân chủng hải quân
QCPH	quy chế phối hợp
QCPKKQ	quân chủng phòng không không quân
QCTM	quảng cáo thương mại
QCTT	quảng cáo trực tuyến
QGGD	quốc gia giáo dục
QGHN	quốc gia hà nội
QGTPHCM	quốc gia thành phố hồ chí minh
QH	quốc hội
QHCC	quan hệ công chúng
QHCT	quy hoạch chi tiết
QHCĐ	quan hệ cổ đông
QHKT	quy hoạch kiến trúc
QHLĐ	quan hệ lao động
QHQT	quan hệ quốc tế
QHSDĐ	quy hoạch sử dụng đất
QHTB	quần hùng tranh bá
QHTD	quan hệ tình dục
QHTDLD	quan hệ tình dục lần đầu
QHTPTNLCNTT	quỹ hỗ trợ phát triển nhân lực công nghệ thông tin
QHVN	quốc hội việt nam
QHXD	quy hoạch xây dựng
QHĐT	quy hoạch đô thị
QKHLM	quỹ khuyến học liên mạng
QKTD	quân khu thủ đô
QKTĐ	quân khu thủ đô
QLBC	quản lý báo cáo
QLBTDT	quản lý bảo tồn di tích
QLBV	quản lý bệnh viện
QLBVR	quản lý bảo vệ rừng
QLBVRPH	ban quản lý bảo vệ rừng phòng hộ
QLBX	quản lý bến xe
QLCCTTĐ	quản lý các công trình trọng điểm
QLCL	quản lý chất lượng
QLCLCTGT	quản lý chất lượng công trình giao thông
QLCLHH	quản lý chất lượng hàng hóa
QLCN	quản lý công nghiệp
QLCS	quản lý công sản
QLCT	quản lý cạnh tranh
QLCTĐT	quản lý công trình đô thị
QLCTĐTĐL	quản lý công trình đô thị đà lạt
QLDA	quản lý dự án
QLDATL	quản lý dự án thủy lợi
QLDATĐ	quản lý dự án thủy điện
QLDAĐT	quản lý dự án đầu tư
QLDB	quản lý đường bộ
QLDT	quản lý đô thị
QLDVN	quản lý dược việt nam
QLGD	quản lý giáo dục
QLGT	quản lý giao thông
QLGTDT	quản lý giao thông đô thị
QLGTĐT	quản lý giao thông đô thị
QLHC	quản lý hành chính
QLHCTTXH	quản lý hành chính trật tự xã hội
QLHCVTTXH	quản lý hành chính về trật tự xã hội
QLHT	quản lý hộ tịch
QLKD	quản lý kinh doanh
QLKT	quản lý khai thác
QLKTCTTL	quản lý khai thác công trình thủy lợi
QLKTX	quản lý ký túc xá
QLLCT	quản lý luật cạnh tranh
QLLĐ	quản lý lao động
QLLĐNN	quản lý lao động nước ngoài
QLLĐVNN	quản lý lao động với nước ngoài
QLMT	quản lí môi trường
QLNBT	quản lý nhà bình thạnh
QLNH	quản lý ngoại hối
QLNLTS	quản lý nguồn lợi thủy sản
QLNN	quản lý nhà nước
QLNS	quản lý nhân sự
QLNT	quản lý nhà trường
QLNĐ	quản lý nhà đất
QLPT	quản lý phát triển
QLPTN	quản lý phát triển nhà
QLRPH	quản lý rừng phòng hộ
QLSD	quản lý sử dụng
QLSDTSNN	quản lý sử dụng tài sản nhà nước
QLSV	quản lý sinh viên
QLTL	quản lý thủy lợi
QLTN	quản lý thủy nông
QLTS	quản lý tài sản
QLTSNN	quản lý tài sản nhà nước
QLTT	quản lý thị trường
QLTTBĐS	quản lý thị trường bất động sản
QLTTXD	quản lý trật tự xây dựng
QLTTĐT	quản lý trật tự đô thị
QLVH	quản lý vận hành
QLVSATTP	quản lý vệ sinh an toàn thực phẩm
QLXD	quản lý xây dựng
QLXNC	quản lý xuất nhập cảnh
QLXNK	quản lý xuất nhập khẩu
QLĐB	quản lý đường bộ
QLĐHVTHKCC	quản lý điều hành vận tải hành khách công cộng
QLĐS	quản lý đường sắt
QLĐT	quản lý đô thị
QLĐĐ	quản lý đất đai
QPPL	quy phạm pháp luật
QRTD	quấy rối tình dục
QS	quân sự
QSDD	quyền sử dụng đất
QSDĐ	quyền sử dụng đất
QSH	quyền sở hữu
QSHCTTĐ	quyền sở hữu công trình trên đất
QSHN	quyền sở hữu nhà
QSHNĐ	quyền sở hữu nhà đất
QSHTT	quyền sở hữu trí tuệ
QSQK	quân sự quân khu
QSTW	quân sự trung ương
QTDN	quản trị doanh nghiệp
QTDND	quỹ tín dụng nhân dân
QTHN	quốc tế hà nội
QTKD	quản trị kinh doanh
QTKDQT	quản trị kinh doanh quốc tế
QTLV	quỹ tấm lòng vàng
QTNL	quản trị nhân lực
QTNS	quản trị nhân sự
QTTC	quản trị tài chính
QTTT	quản trị tri thức
QTTV	quản trị thư viện
QTVN	quốc tịch việt nam
QTVP	quản trị văn phòng
QĐCC	quyết định cưỡng chế
QĐGĐT	quyết định giám đốc thẩm
QĐKL	quyết định kỷ luật
QĐND	quân đội nhân dân
QĐNDVN	quân đội nhân dân việt nam
QĐNH	quyết định nghỉ hưu
QĐST	quyết định sa thải
QĐTT	quy định tạm thời
QĐXB	quyết định xuất bản
QĐĐC	quyết định đính chính
RLAACC	rối loạn ám ảnh cưỡng chế
RLCD	rối loạn cương dương
RLLA	rối loạn lo âu
RLMM	rối loạn mỡ máu
RLPL	rối loạn phân ly
RNLG	rừng nguyên liệu giấy
RNTT	rối nhiễu tâm trí
RPHĐN	rừng phòng hộ đầu nguồn
RTCN	rác thải công nghiệp
RTYT	rác thải y tế
RĐTG	rung động thư giãn
SBCR	sân bay cam ranh
SBD	số báo danh
SBT	sách bài tập
SCTBCN	sửa chữa thiết bị công nghiệp
SCTM	sự cố treo máy
SCĐB	sửa chữa đường bộ
SDDBT	suy dinh dưỡng bào thai
SDLĐ	sử dụng lao động
SDT	số điện thoại
SDĐ	sử dụng đất
SDĐNN	sử dụng đất nông nghiệp
SGDCK	sở giao dịch chứng khoán
SGDVL	sàn giao dịch việc làm
SGGP	sài gòn giải phóng
SGK	sách giáo khoa
SGNT	sài gòn nhật thực
SGTT	sài gòn tíêp thị
SGTVT	sở giao thông vận tải
SHBD	số hiệu bản đồ
SHCN	sở hữu công nghiệp
SHNN	sở hữu nhà nước
SHPT	sinh học phổ thông
SHTT	sở hữu trí tuệ
SKBMTE	sức khỏe bà mẹ trẻ em
SKCT	sáng kiến cải tiến
SKCTKT	sáng kiến cải tiến kỉ thuật
SKCĐ	sức khoẻ cộng đồng
SKHĐT	sở kế hoạch đầu tư
SKKN	sáng kiến kinh nghiệm
SKLĐ	sức khỏe lao động
SKMT	sức khỏe môi trường
SKSS	sức khoẻ sinh sản
SKST	sáng kiến sáng tạo
SKTD	sức khỏe tình dục
SKTT	sức khỏe tinh thần
SKĐA	sân khấu điện ảnh
SLNA	sông lam nghệ an
SLĐTBXH	sở lao động thương binh xã hội
SMMT	sơn mài mỹ thuật
SMĐH	sao mai điểm hẹn
SN	sinh năm
SPCN	sản phẩm công nghiệp
SPHH	sản phẩm hàng hóa
SPHN	sư phạm hà nội
SPKT	sư phạm kỹ thuật
SPST	sản phẩm sinh thái
SQLQ	sĩ quan lục quân
SRKST	sốt rét ký sinh trùng
SRKSTCT	sốt rét ký sinh trùng côn trùng
SSCĐ	sẵn sàng chiến đấu
STBTH	sách thiết bị trường học
STDM	siêu thị điện máy
STHS	sơ thẩm hình sự
STKTN	sách tham khảo trắc nghiệm
STMT	suy thận mãn tính
STQC	sang thương quanh chóp
STT	số thứ tự
STTC	siêu thị tình cảm
STTK	sợi trục thần kinh
STTN	sử thi tây nguyên
STTT	sinh thiết tức thì
STĐT	sinh thái đô thị
SV	sinh viên
SVBC	sinh viên báo chí
SVD	sân vận động
SVHS	sinh viên học sinh
SVHTT	sở văn hóa thông tin
SVNCKH	sinh viên nghiên cứu khoa học
SVNN	sinh viên nước ngoài
SVTN	sinh viên tình nguyện
SVVN	sinh viên việt nam
SVĐ	sân vận động
SVĐH	sinh viên đại học
SVĐQG	sân vận động quốc gia
SVĐTT	sân vận động trung tâm
SVĐV	sao vàng đất việt
SX	sản xuất
SXBB	sản xuất bao bì
SXCN	sản xuất công nghiệp
SXD	sở xây dựng
SXKD	sản xuất kinh doanh
SXNN	sản xuất nông nghiệp
SXSH	sản xuất sạch hơn
SXTĐ	sản xuất trọng điểm
SXVLXD	sản xuất vật liệu xây dựng
SXXK	sản xuất xuất khẩu
SXXNK	sản xuất xuất nhập khẩu
SXXNKBD	sản xuất xuất nhập khẩu bình dương
SĐG	sàn đấu giá
SĐH	sau đại học
SĐT	số điện thoại
TACN	thức ăn chăn nuôi
TADN	tiếng anh doanh nghiệp
TAND	tòa án nhân dân
TANDTC	tòa án nhân dân tối cao
TANDTP	tòa án nhân dân thành phố
TANDTPHCM	tòa án nhân dân thành phố hồ chí minh
TAQS	tòa án quân sự
TAĐP	thức ăn đường phố
TB	thông báo
TBBP	tình bạn bốn phương
TBBTTN	trung bình bài thi tốt nghiệp
TBCN	thiết bị công nghệ
TBCS	thiết bị chiếu sáng
TBDH	thiết bị dạy học
TBDĐ	thuê bao di động
TBDĐTT	thuê bao di động trả trước
TBGD	thiết bị giáo dục
TBKT	thời báo kinh tế
TBKTD	thiết bị kỹ thuật điện
TBKTSG	thời báo kinh tế sài gòn
TBKTVN	thời báo kinh tế việt nam
TBKTĐ	thiết bị kỹ thuật điện
TBLS	thương binh liệt sĩ
TBLĐ	thương binh lao động
TBMMN	tai biến mạch máu não
TBN	tây ban nha
TBNN	trung bình nhiều năm
TBTG	thuê bao trọn gói
TBTH	thiết bị trường học
TBTKĐ	thiết bị tiết kiệm điện
TBTT	thuê bao trả trước
TBXH	thương binh xã hội
TBYT	thiết bị y tế
TBĐT	thuê bao điện thoại
TCBC	thông cáo báo chí
TCBD	tổng cục bưu điện
TCBP	thừa cân béo phì
TCBVNTD	tiêu chuẩn bảo vệ người tiêu dùng
TCBĐ	tổng cục bưu điện
TCCB	tổ chức cán bộ
TCCL	tiêu chuẩn chất lượng
TCCN	trung cấp chuyên nghiệp
TCCP	tiêu chuẩn cho phép
TCCQ	tổ chức chính quyền
TCCS	tổng cục cảnh sát
TCCT	tổng cục chính trị
TCCVTQT	trộm cắp cước viễn thông quốc tế
TCDL	tổng cục du lịch
TCDLVN	tổng cục du lịch việt nam
TCDN	tài chính doanh nghiệp
TCHQ	tổng cục hải quan
TCHTQ	tổng công hội trung quốc
TCKD	trò chơi kinh doanh
TCKH	tạp chí khoa học
TCKT	tài chính kế toán
TCLĐ	tranh chấp lao động
TCMN	thủ công mỹ nghệ
TCMR	tiêm chủng mở rộng
TCMRQG	tiêm chủng mở rộng quốc gia
TCN	trước công nguyên
TCNH	tài chính ngân hàng
TCNS	tổ chức nhân sự
TCPK	tác chiến phòng không
TCQG	trường chuẩn quốc gia
TCQT	tài chính quốc tế
TCSPMN	trung cấp sư phạm mầm non
TCSS	trầm cảm sau sinh
TCTC	tổ chức tài chính
TCTCDLCL	tổng cục tiêu chuẩn đo lường chất lượng
TCTCN	tổng công ty cấp nước
TCTCSVN	tổng công ty cao su việt nam
TCTD	tổ chức tín dụng
TCTDTT	tổng cục thể dục thể thao
TCTK	tổng cục thống kê
TCTL	tín chỉ tích lũy
TCTNN	tổng công ty nhà nước
TCTS	thái cực trường sinh
TCTT	tài chính tiền tệ
TCTXDCTGT	tổng công ty xây dựng công trình giao thông
TCVG	tài chính vật giá
TCVN	tiêu chuẩn việt nam
TCVSG	thảo cầm viên sài gòn
TCXD	tiêu chuẩn xây dựng
TCXDVN	tiêu chuẩn xây dựng việt nam
TCYD	trưng cầu ý dân
TCYTQB	trung cấp y tế quảng bình
TCYTTG	tổ chức y tế thế giới
TCĐC	tổng cục địa chính
TCĐLCL	tiêu chuẩn đo lường chất lượng
TCĐN	tài chính đối ngoại
TCĐS	tổng cục đường sắt
TCĐTCT	trò chơi điện tử có thưởng
TDDC	tự do dân chủ
TDLĐ	tuyển dụng lao động
TDND	tín dụng nhân dân
TDNT	thể dục nghệ thuật
TDTC	tư duy tích cực
TDTE	tình dục trẻ em
TDTKC	tình dục tự kiềm chế
TDTM	thể dục thẩm mỹ
TDTS	tổng diện tích sàn
TDTT	thể dục thể thao
TELT	trẻ em lang thang
TEVN	trẻ em việt nam
TGCC	thần giao cách cảm
TGCT	thời gian công tác
TGD	tổng giám đốc
TGDT	tôn giáo dân tộc
TGDĐ	thế giới di động
TGGD	trị giá giao dịch
TGGT	thế giới giải trí
TGHM	thế giới hoàn mỹ
TGLX	tứ giác long xuyên
TGNS	thế giới nghệ sĩ
TGNV	thế giới người việt
TGPL	trợ giúp pháp luật
TGPN	thế giới phụ nữ
TGVH	thế giới văn hóa
TGVL	thế giới võ lâm
TGVT	thế giới vi tính
TGĐ	tổng giám đốc
THADS	thi hành án dân sự
THAPT	thi hành án phạt tù
THBC	trung học bán công
THBT	trung học bổ túc
THBTVH	trung học bổ túc văn hóa
THBĐ	tin học bình định
THCA	truyền hình công an
THCB	tin học cơ bản
THCN	trung học chuyên nghiệp
THCS	trung học cơ sở
THCSNĐ	thực hiện chính sách nhà đất
THCVN	truyền hình cáp việt nam
THDL	tiểu học dân lập
THDLKT	trung học dân lập kinh tế
THGT	tín hiệu giao thông
THHN	tổng hợp hướng nghiệp
THKT	thực hành kế toán
THKTNV	trung học kỹ thuật nghiệp vụ
THLV	tân huấn luyện viên
THNC	trung hòa nhân chính
THNS	thương hiệu nông sản
THNXC	thông hành nhập xuất cảnh
THPH	trung học phổ thông
THPT	trung học phổ thông
THPTDL	trung học phổ thông dân lập
THQCT	thực hành quyền công tố
THQG	thương hiệu quốc gia
THSCT	tôn hoa sen cần thơ
THSP	thực hành sư phạm
THTH	tiếng hát truyền hình
THTK	thực hành tiết kiệm
THTM	tạo hình thẩm mỹ
THTT	truyền hình trực tiếp
THVN	truyền hình việt nam
THVP	tin học văn phòng
THYT	trung học y tế
THYTLA	trung học y tế long an
THĐH	thương hiệu đại học
TKBS	thiết kế bìa sách
TKBĐ	tiết kiệm bưu điện
TKCLP	tiết kiệm chống lãng phí
TKCN	tìm kiếm cứu nạn
TKHQ	tờ khai hải quan
TKKT	thiết kế kỹ thuật
TKMX	trực khuẩn mủ xanh
TKSBPCK	trạm kiểm soát biên phòng cửa khẩu
TKSLHCKQT	trạm kiểm soát liên hợp cửa khẩu quốc tế
TKSVN	than khoáng sản việt nam
TKTK	thuốc khử trùng kho
TKTN	tiết kiệm tình nghĩa
TKTQ	thư ký trường quay
TKTS	thư ký tòa soạn
TKTST	thuốc kích thích sinh trưởng
TKTT	thiết kế thời trang
TKXD	thiết kế xây dựng
TLCS	tuyển lựa ca sĩ
TLGD	tư liệu giáo dục
TLGT	tỉ lệ giới tính
TLGTKS	tỉ lệ giới tính khi sinh
TLKH	tài liệu khoa học
TLKHTƯ	tài liệu khoa học
TLNL	thuốc lá nhập lậu
TLNS	tôi là ngôi sao
TLSQ	tổng lãnh sự quán
TLSSG	thủy lợi sông sài gòn
TLTN	trả lời trắc nghiệm
TLTT	tư lệnh thông tin
TLVA	thụ lý vụ án
TLVCĐ	tấm lòng vàng công đoàn
TLVLĐ	tấm lòng vàng lao động
TLVĐ	tự lực văn đoàn
TLĐLĐ	tổng liên đoàn lao động
TLĐLĐVN	tổng liên đoàn lao động việt nam
TM	thương mại
TMCN	thương mại công nghiệp
TMCNVN	thương mại công nghiệp việt nam
TMCP	thương mại cổ phần
TMCPQĐ	thương mại cổ phần quân đội
TMDK	thương mại dầu khí
TMDL	thương mại du lịch
TMDV	thương mại dịch vụ
TMH	tai mũi họng
TMLB	thương mại lao bảo
TMLS	thương mại lâm sản
TMMN	thương mại miền núi
TMMP	tên miền miễn phí
TMNCSG	thép miền nam cảng sài gòn
TMNN	thương mại nhà nước
TMNĐ	tuyết miền nhiệt đới
TMQD	thương mại quốc doanh
TMSS	tin mừng sự sống
TMSX	thương mại sản xuất
TMTDTS	thu mua trưng dụng tài sản
TMTH	thương mại tổng hợp
TMTHMN	thương mại tổng hợp miền núi
TMTV	tên miền tiếng việt
TMTW	truyền máu trung ương
TMXNK	thương mại xuất nhập khẩu
TMĐB	thương mại đặc biệt
TMĐT	thương mại điện tử
TNCA	tầm nhìn châu á
TNCN	thu nhập cá nhân
TNCQ	thanh niên cứu quốc
TNCS	thanh niên cộng sản
TNCSHCM	thanh niên cộng sản hồ chí minh
TNCĐ	tốt nghiệp cao đẳng
TNDC	thanh niên dân chủ
TNDCTG	thanh niên dân chủ thế giới
TNDN	thu nhập doanh nghiệp
TNDS	trách nhiệm dân sự
TNDT	thống nhất dân tộc
TNDTTS	thanh niên dân tộc thiểu số
TNGT	tai nạn giao thông
TNHC	trinh nữ hoang cung
TNHH	trách nhiệm hữu hạn
TNHHNN	trách nhiệm hữu hạn nhà nước
TNHN	thanh niên hà nội
TNKQ	trắc nghiệm khách quan
TNKS	tài nguyên khoáng sản
TNKT	thanh niên khuyết tật
TNLN	thanh niên lập nghiệp
TNLĐ	tai nạn lao động
TNMT	tài nguyên môi trường
TNMTNĐ	tài nguyên môi trường nhà đất
TNND	tiếng nói nhân dân
TNNDCM	thanh niên nhân dân cách mạng
TNNDTP	tiếng nói nhân dân thành phố
TNNT	thanh niên nông thôn
TNPH	tài nguyên phục hồi
TNPT	tốt nghiệp phổ thông
TNPTTH	tốt nghiệp phổ thông trung học
TNS	thượng nghị sĩ
TNSTN	tài năng sáng tạo nữ
TNSV	thanh niên sinh viên
TNTC	tốt nghiệp trung cấp
TNTHPT	tốt nghiệp trung học phổ thông
TNTN	thanh niên tình nguyện
TNTP	thiếu niên tiền phong
TNTQ	trào ngược thực quản
TNTS	thanh niên tuần san
TNTT	thiếu nhi thánh thể
TNV	tình nguyện viên
TNVN	tiếng nói việt nam
TNVSMT	thoát nước vệ sinh môi trường
TNXH	tệ nạn xã hội
TNXK	thanh niên xung kích
TNXKTN	thanh niên xung kích tình nguyện
TNXN	thanh niên xuất ngũ
TNXP	thanh niên xung phong
TNXPGPMN	thanh niên xung phong giải phóng miền nam
TNĐH	tốt nghiệp đại học
TNĐT	thoát nước đô thị
TP	thành phố
TPBB	tín phiếu bắt buộc
TPBH	thành phố biên hòa
TPCGC	tiêm phòng cúm gia cầm
TPCL	tây phương cực lạc
TPCM	thành phố cà mau
TPCN	thực phẩm chức năng
TPCP	trái phiếu chính phủ
TPDL	thực phẩm đông lạnh
TPDT	trái phiếu đô thị
TPHCM	thành phố hồ chí minh
TPHN	thành phố hà nội
TPHP	thành phố hải phòng
TPKAT	thực phẩm không an toàn
TPMN	túi phình mạch não
TPNS	thực phẩm nông sản
TPNT	tác phẩm nghệ thuật
TPPY	tư pháp phú yên
TPQN	thành phố quy nhơn
TPSA	tương phản siêu âm
TPVT	thành phố vũng tàu
TPĐN	thành phố đà nẵng
TQDN	tam quốc diễn nghĩa
TQGC	tổ quốc ghi công
TQKC	toàn quốc kháng chiến
TQVN	tổ quốc việt nam
TRPH	trồng rừng phòng hộ
TRPHSB	trồng rừng phòng hộ sông bồ
TS	tiến sĩ
TSBHT	tây sơn bi hùng truyện
TSBT	tổng số bàn thắng
TSBĐ	tài sản bảo đảm
TSCD	tài sản cố định
TSCĐ	tài sản cố định
TSDĐ	tiền sử dụng đất
TSDĐNN	thuế sử dụng đất nông nghiệp
TSGTKS	tỉ số giới tính khi sinh
TSHL	thủy sản hạ long
TSKH	tiến sĩ khoa học
TSKV	tần số khu vực
TSMT	tiếp sức mùa thi
TSN	tân sơn nhất
TSNL	thủy sản nông lâm
TSNN	tài sản nhà nước
TSPT	tuyển sinh phổ thông
TSQS	tuyển sinh quân sự
TSTC	trà sữa trân châu
TSTD	tài sản tồn đọng
TSTH	tầng sôi tạo hạt
TSTNKDT	thắp sáng tài năng kinh doanh trẻ
TSTĐKQT	trại sáng tác điêu khắc quốc tế
TSXHCN	tài sản xã hội chũ nghĩa
TSĐKDT	thí sinh đăng ký dự thi
TT&TT	thông tin và truyền thông
TTATGT	trật tự an toàn giao thông
TTATXH	trật tự an toàn xã hội
TTB	trang thiết bị
TTBC	trung tâm báo chí
TTBCTYT	trang thiết bị công trình y tế
TTBDVH	trung tâm bồi dưỡng văn hóa
TTBH	thị trấn bỏ hoang
TTBTDT	trung tâm bảo tồn di tích
TTBTDTCĐ	trung tâm bảo tồn di tích cố đô
TTBTXH	trung tâm bảo trợ xã hội
TTBVQTG	trung tâm bảo vệ quyền tác giả
TTBYT	trang thiết bị y tế
TTBĐGTS	trung tâm bán đấu giá tài sản
TTBĐS	thị trường bất động sản
TTCB	tuổi trẻ cao bằng
TTCC	trật tự công cộng
TTCD	trung tâm chống độc
TTCHG	trung tâm cứu hộ gấu
TTCK	thị trường chứng khoán
TTCKVN	thị trường chứng khoán việt nam
TTCN	thị trường chuyển nhượng
TTCNMT	tiểu thủ công nghiệp miền trung
TTCP	thanh tra chính phủ
TTCPQG	trung tâm chiếu phim quốc gia
TTCT	tôm thẻ chân trắng
TTCTXH	thực tập công tác xã hội
TTCV	thanh tra công vụ
TTCĐ	trung tâm cá độ
TTDB	tiêu thụ đặc biệt
TTDBKTTV	trung tâm dự báo khí tượng thủy văn
TTDBKTTVTW	trung tâm dự báo khí tượng thủy văn trung ương
TTDBKTTVTƯ	trung tâm dự báo khí tượng thủy văn trung ương
TTDD	thông tin di động
TTDN	trung tâm dạy nghề
TTDVBĐG	trung tâm dịch vụ bán đấu giá
TTDVKH	trung tâm dịch vụ khách hàng
TTDVKTQLB	trung tâm dịch vụ kỹ thuật quản lý bay
TTDVVL	trung tâm dịch vụ việc làm
TTDVĐC	trung tâm dịch vụ địa chính
TTDĐ	thông tin di động
TTGC	thị thường giá cả
TTGD	trung tâm giao dịch
TTGDBĐS	trung tâm giao dịch bất động sản
TTGDCK	trung tâm giao dịch chứng khoán
TTGDCKHN	trung tâm giao dịch chứng khoán hà nội
TTGDCNTT	trung tâm giao dịch công nghệ thông tin
TTGDCT	tập trung giáo dục cải tạo
TTGDLĐ	trung tâm giáo dục lao động
TTGDLĐTVL	trung tâm giáo dục lao động tạo việc làm
TTGDLĐXH	trung tâm giáo dục lao động xã hội
TTGDNPL	trung tâm giao dịch nguyên phụ liệu
TTGDSK	truyền thông giáo dục sức khỏe
TTGDTX	trung tâm giáo dục thường xuyên
TTGT	thanh tra giao thông
TTGTCC	thanh tra giao thông công chánh
TTGTSP	trung tâm giới thiệu sản phẩm
TTGTVL	trung tâm giới thiệu việc làm
TTGTVLBĐ	trung tâm giới thiệu việc làm bình định
TTGTĐS	thanh tra giao thông đường sắt
TTGĐ	tiếp thị gia đình
TTHC	thủ tục hành chính
TTHCM	tư tưởng hồ chí minh
TTHCTL	trung tâm hội chợ triển lãm
TTHK	tiếp thị hành khách
TTHLQG	trung tâm huấn luyện quốc gia
TTHLTT	trung tâm huấn luyện thể thao
TTHLTTQG	trung tâm huấn luyện thể thao quốc gia
TTHLTTQGI	trung tâm huấn luyện thể thao quốc gia i
TTHN	trung tâm hội nghị
TTHNQG	trung tâm hội nghị quốc gia
TTHS	tố tụng hình sự
TTHTCC	tiếp tục hợp tác chặt chẽ
TTHTKH	trung tâm hỗ trợ khách hàng
TTHTSV	trung tâm hỗ trợ sinh viên
TTHĐTTN	trung tâm hoạt động thanh thiếu niên
TTHĐTTNPY	trung tâm hoạt động thanh thiếu nhi phú yên
TTK	tổng thư ký
TTKDTM	thanh toán không dùng tiền mặt
TTKDYTQT	trung tâm kiểm dịch y tế quốc tế
TTKH	thông tin khoa học
TTKHTN	trung tâm khoa học tự nhiên
TTKN	trung tâm kiểm nghiệm
TTKNHN	trung tâm khuyến nông hà nội
TTKS	tuần tra kiểm soát
TTKSGT	tuần tra kiểm soát giao thông
TTKSTSKV	trung tâm kiểm soát tần số khu vực
TTKTPTQĐ	trung tâm khai thác phát triển quỹ đất
TTKTTV	trung tâm khí tượng thủy văn
TTKĐQG	trung tâm kiểm định quốc gia
TTKĐTBVTVPN	trung tâm kiểm định thuốc bảo vệ thực vật phía nam
TTKĐXD	trung tâm kiểm định xây dựng
TTLB	thông tư liên bộ
TTLHVHDL	trung tâm lễ hội văn hóa du lịch
TTLK	trung tâm lưu ký
TTLKCK	trung tâm lưu ký chứng khoán
TTLL	thông tin liên lạc
TTLN	thông tư liên ngành
TTLT	thông tư liên tịch
TTLTQG	trung tâm lưu trữ quốc gia
TTLĐ	thông tin lưu động
TTLĐNN	trung tâm lao động ngoài nước
TTLĐTN	truyền thông lưu động thanh niên
TTMS	trung tâm mua sắm
TTMT	từ thiện miền trung
TTNC	trung tâm nghiên cứu
TTNCGC	trung tâm nghiên cứu gia cầm
TTNCKTKH	trung tâm nghiên cứu khí tượng khí hậu
TTNCQH	trung tâm nghiên cứu quốc học
TTND	thanh tra nhân dân
TTNKT	thể thao người khuyết tật
TTNN	thể thao ngày nay
TTNNT	trang trí nội ngoại thất
TTNNĐ	thanh thiếu niên nhi đồng
TTNT	trang trí nội thất
TTNĐ	trung tâm nhiệt điện
TTPC	trung tâm phòng chống
TTPCBXH	trung tâm phòng chống bệnh xã hội
TTPL	tâm thần phân liệt
TTQBS	teo thực quản bẩm sinh
TTQG	thể thao quốc gia
TTQGQT	trung tâm quốc gia quan trắc
TTQL	trung tâm quản lý
TTQLKT	trật tự quản lý kinh tế
TTQLKTVCV	trật tự quản lý kinh tế và chức vụ
TTQT	thanh toán quốc tế
TTRHM	trung tâm răng hàm mặt
TTSG	trung tâm sài gòn
TTSH	trung tâm sát hạch
TTSV	thể thao sinh viên
TTTC	trung tâm tài chính
TTTG	thị trường thế giới
TTTH	trung tâm tin học
TTTHDL	trung tâm tích hợp dữ liệu
TTTKCN	trung tâm triển khai công nghệ
TTTM	trung tâm thương mại
TTTMH	trung tâm tai mũi họng
TTTMPH	trung tâm thương mại phức hợp
TTTN	thực tập tốt nghiệp
TTTON	thụ tinh trong ống nghiệm
TTTT	thực tập thực tế
TTTTC	thể thao thành tích cao
TTTTCP	trung tâm thanh toán cước phí
TTTTN	trí thức trẻ tình nguyện
TTTTTD	trung tâm thông tin tín dụng
TTTTTL	trung tâm thể thao thành long
TTTVCĐ	trung tâm tham vấn cộng đồng
TTTVPTVHBĐ	trung tâm tư vấn phát triển văn hóa bản địa
TTTY	tiểu thuyết tình yêu
TTUDCNM	trung tâm ứng dụng công nghệ mới
TTUDKH	trung tâm ứng dụng khoa học
TTVAQ	thiên thần và ác quỷ
TTVG	tuyên truyền viên giỏi
TTVH	thể thao văn hóa
TTVHP	trung tâm văn hóa pháp
TTVHTMSG	trung tâm văn hóa thương mại sài gòn
TTVHTT	trung tâm văn hóa thể thao
TTVHTW	tư tưởng văn hóa trung ương
TTVHTƯ	tư tưởng văn hóa trung ương
TTVL	trung tâm việc làm
TTVN	trí tuệ việt nam
TTVTĐL	thông tin viễn thông điện lực
TTX	thông tấn xã
TTXD	thanh tra xây dựng
TTXH	trật tự xã hội
TTXKLĐ	trung tâm xuất khẩu lao động
TTXTTM	trung tâm xúc tiến thương mại
TTXVN	thông tấn xã việt nam
TTYT	trung tâm y tế
TTYTDP	trung tâm y tế dự phòng
TTYTDPHN	trung tâm y tế dự phòng hà nội
TTYTNT	trung tâm y tế ngành than
TTYTQ	trung tâm y tế quận
TTĐA	trung tâm điện ảnh
TTĐB	tiêu thụ đặc biệt
TTĐG	thủ tục đấu giá
TTĐH	trung tâm điều hành
TTĐHBC	trung tâm điều hành báo chí
TTĐK	trung tâm đăng kiểm
TTĐN	thông tin đối ngoại
TTĐT	thông tin điện tử
TTĐĐHTĐ	trung tâm điều độ hệ thống điện
TTĐĐĐQG	trung tâm điều độ điện quốc gia
TV	ti vi
TVCN	tư vấn chọn nghề
TVCT	thành viên chính thức
TVDH	tư vấn du học
TVGS	tư vấn giám sát
TVGĐ	tư vấn giám định
TVHN	tư vấn hướng nghiệp
TVHNBVN	thường vụ hội nhà báo việt nam
TVKT	tư vấn kỹ thuật
TVPL	tư vấn pháp luật
TVQH	thường vụ quốc hội
TVSKCĐ	tư vấn sức khỏe cộng đồng
TVTH	tiếng việt thực hành
TVTK	tư vấn thiết kế
TVTLTT	thiền viện trúc lâm tây thiên
TVTU	thường vụ tỉnh ủy
TVVCS	tư vấn viên cơ sở
TVVN	thiên văn việt nam
TVXD	tư vấn xây dựng
TVXDTL	tư vấn xây dựng thủy lợi
TVĐU	thường vụ đảng ủy
TVĐĐ	thoát vị đĩa đệm
TWMTTQVN	trung ương mặt trận tổ quốc việt nam
TX	thị xã
TXBL	thị xã bạc liêu
TXCT	tiếp xúc cử tri
TXTA	thị xã tân an
TXTDM	thị xã thủ dầu một
TYHG	thú y hậu giang
TYTS	thú y thủy sản
TĐBK	từ điển bách khoa
TĐBKVN	từ điển bách khoa việt nam
TĐBL	thủy điện bảo lộc
TĐCNCSVN	tập đoàn công nghiệp cao su việt nam
TĐCS	thi đua chính sách
TĐDM	tập đoàn dệt may
TĐDMVN	tập đoàn dệt may việt nam
TĐKT	tập đoàn kinh tế
TĐSL	thủy điện sơn la
TĐTC	tiến độ thi công
TĐTH	thiên địa tinh hoa
TĐTN	trường đào tạo nghề
TĐTVN	tập đoàn than việt nam
TĐYDBL	tập đoàn y dược bảo long
TƯLĐ	thỏa ước lao động
TƯLĐTT	thõa ước lao động tập thể
TƯMTTQVN	trung ương mặt trận tổ quốc việt nam
UB	uỷ ban
UBATGT	ủy ban an toàn giao thông
UBATGTQG	ủy ban an toàn giao thông quốc gia
UBATTP	ủy ban an toàn thực phẩm
UBATTPLMCA	ủy ban an toàn thực phẩm liên minh châu âu
UBBC	ủy ban bầu cử
UBBCQH	ủy ban bầu cử quốc hội
UBBV	ủy ban bảo vệ
UBBVCSTE	ủy ban bảo vệ chăm sóc trẻ em
UBCKNN	ủy ban chứng khoán nhà nước
UBCTN	uỷ ban chống tham nhũng
UBDN	uỷ ban dân nguyện
UBDS	uỷ ban dân số
UBDSGD	ủy ban dân số gia đình
UBDSGĐ	ủy ban dân số gia đình
UBDSGĐTE	ủy ban dân số gia đình trẻ em
UBDSKHH	ủy ban dân số kế hoạch hóa
UBDSKHHGĐ	uỷ ban dân số kế hoạch hóa gia đình
UBDT	ủy ban điều tra
UBDTMN	ủy ban dân tộc miền núi
UBHC	ủy ban hành chính
UBHCKC	uỷ ban hành chính kháng chiến
UBKC	ủy ban kháng chiến
UBKH	ủy ban khoa học
UBKHCN	uỷ ban khoa học công nghệ
UBKHCNMT	ủy ban khoa học công nghệ môi trường
UBKN	ủy ban khởi nghĩa
UBKT	ủy ban kiểm tra
UBKTCĐ	ủy ban kiểm tra công đoàn
UBKTNS	ủy ban kinh tế ngân sách
UBKTTU	ủy ban kiểm tra trung ương
UBKTTUHG	uỷ ban kiểm tra tỉnh uỷ hậu giang
UBKTTƯ	ủy ban kiểm tra trung ương
UBMT	uỷ ban mặt trận
UBMTTQ	uỷ ban mặt trận tổ quốc việt nam
UBMTTQTP	ủy ban mặt trận tổ quốc thành phố
UBMTTQVN	ủy ban mặt trận tổ quốc việt nam
UBND	ủy ban nhân dân
UBNDTP	uỷ ban nhân dân thành phố
UBNDTPHCM	ủy ban nhân dân thành phố hồ chí minh
UBNN	uỷ ban nhà nước
UBNVN	uỷ ban người việt nam
UBNVNONN	ủy ban người việt nam ở nước ngoài
UBNVONN	ủy ban người việt ở nước ngoài
UBPC	ủy ban phòng chống
UBPLQH	ủy ban pháp luật quốc hội
UBQG	ủy ban quốc gia
UBQGTKCN	ủy ban quốc gia tìm kiếm cứu nạn
UBQGVSTBCPN	uỷ ban quốc gia vì sự tiến bộ của phụ nữ
UBQP	ủy ban quốc phòng
UBTC	uỷ ban tài chính
UBTCNS	ủy ban tài chính ngân sách
UBTDTT	uỷ ban thể dục thể thao
UBTP	ủy ban tư pháp
UBTT	ủy ban tương trợ
UBTV	ủy ban thường vụ
UBTVQH	ủy ban thường vụ quốc hội
UBTW	ủy ban trung ương
UBTWMTTQ	ủy ban trung ương mặt trận tổ quốc
UBTWMTTQVN	ủy ban trung ương mặt trận tổ quốc việt nam
UBTƯ	ủy ban trung ương
UBTƯMTTQ	ủy ban trung ương mặt trận tổ quốc
UBTƯMTTQVN	ủy ban trung ương mặt trận tổ quốc việt nam
UBVCVĐXH	ủy ban về các vấn đề xã hội
UBVH	ủy ban văn hóa
UBVNVNONN	ủy ban về người việt nam ở nước ngoài
UBXD	uỷ ban xây dựng
UBĐKCG	ủy ban đoàn kết công giáo
UBĐN	ủy ban đối ngoại
UBĐNQH	ủy ban đối ngoại quốc hội
UBĐP	uỷ ban điều phối
UBĐT	ủy ban điều tra
UCV	ứng cử viên
UDKH	ứng dụng khoa học
UNBD	uỷ ban nhân dân
UNDP	Chương trình Phát triển Liên Hiệp Quốc
UPĐTTL	u phì đại tuyến tiền liệt
USD/OUNCE	diu ét đi một ao
USD/ĐỒNG	diu ét đi trên đồng
UTBMTBG	ung thư biểu mô tế bào gan
UTCTC	ung thư cổ tử cung
UTDV	ung thư dương vật
UTNK	ủy thác nhập khẩu
UTQLV	uỷ thác quản lý vốn
UTTLT	ung thư tiền liệt tuyến
UTĐTT	ung thư đại trực tràng
UV	ủy viên
UVBCH	uỷ viên ban chấp hành
UVBCT	uỷ viên bộ chính trị
UVTV	ủy viên thường vụ
UVTƯ	uỷ viên trung ương
VBCC	văn bằng chứng chỉ
VBHS	văn bản hồ sơ
VBLH	vương bất lưu hành
VBQPPL	văn bản quy phạm pháp luật
VBVBM	viện bảo vệ bà mẹ
VBVSKTE	viện bảo vệ sức khỏe trẻ em
VCDD	vi chất dinh dưỡng
VCK	vòng chung kết
VCQT	vùng chim quan trọng
VCTY	ván cờ tình yêu
VCVN	viên chức việt nam
VDCN	vật dụng cá nhân
VDDQG	viện dinh dưỡng quốc gia
VDTP	võ đường thanh phong
VGSV	viêm gan siêu vi
VHCS	văn hóa công sở
VHCĐ	văn học cổ điển
VHDG	văn hóa dân gian
VHDN	văn hóa doanh nghiệp
VHDT	văn hóa dân tộc
VHGD	văn hóa giáo dục
VHGDTNTN	văn hóa giáo dục thanh niên thiếu niên
VHHN	văn hóa hữu nghị
VHHQ	văn hóa hàn quốc
VHHTMTƯ	viện huyết học truyền máu trung ương
VHLKH	viện hàn lâm khoa học
VHLS	văn hóa long sơn
VHLĐ	văn hóa lao động
VHLĐHN	văn hóa lao động hữu nghị
VHNLĐ	văn hóa người lao động
VHNN	văn học nước ngoài
VHNT	văn hóa nghệ thuật
VHNTCDTTS	văn học nghệ thuật các dân tộc thiểu số
VHNTCDTTSVN	văn học nghệ thuật các dân tộc thiểu số việt nam
VHNTVN	văn hóa nghệ thuật việt nam
VHPD	vạn hoa phi điểu
VHQC	văn hóa quần chúng
VHSG	văn hóa sài gòn
VHTDTT	văn hóa thể dục thể thao
VHTG	văn hóa thế giới
VHTH	văn hóa tổng hợp
VHTN	văn học thiếu nhi
VHTT	văn hóa thông tin
VHTTCS	văn hóa thông tin cơ sở
VHTTDL	văn hóa thể thao du lịch
VHTTDT	văn hóa thể dục thể thao
VHTTTN	văn hóa thể thao thanh niên
VHVN	văn học việt nam
VHĐT	văn học đời trần
VKHHS	viện khoa học hình sự
VKHKTNNMN	viện khoa học kỹ thuật nông nghiệp miền nam
VKHTT	viện khoa học thanh tra
VKS	viện kiểm sát
VKSND	viện kiểm sát nhân dân
VKSNDTC	viện kiểm sát nhân dân tối cao
VKSNDTP	viện kiểm sát nhân dân thành phố
VKTBKT	vũ khí trang bị kỹ thuật
VKTTĐ	vùng kinh tế trọng điểm
VKTTĐMT	vùng kinh tế trọng điểm miền trung
VKTTĐPN	vùng kinh tế trọng điểm phía nam
VLCA	vật lý châu á
VLCM	vượt lên chính mình
VLCN	vật liệu cách nhiệt
VLKT	vật lý kỹ thuật
VLTK	võ lâm truyền kỳ
VLTL	vật lý trị liệu
VLXD	vật liệu xây dựng
VLĐC	vật lý địa cầu
VMNM	viêm màng não mủ
VNAH	việt nam anh hùng
VNCA	văn nghệ công an
VNCH	việt nam cộng hòa
VNCLC	việt nam chất lượng cao
VNCN	văn nghệ chủ nhật
VNCNTTS	viện nghiên cứu nuôi trồng thủy sản
VND	việt nam đồng
VNDCCH	việt nam dân chủ cộng hòa
VNDG	văn nghệ dân gian
VNNB	viêm não nhật bản
VNNKT	văn nghệ người khuyết tật
VNQDĐ	việt nam quốc dân đảng
VNQĐ	văn nghệ quân đội
VNTCNCR	vùng nuôi tôm công nghiệp cam ranh
VNĐ	việt nam đồng
VP	văn phòng
VPBCĐ	văn phòng ban chỉ đạo
VPBQ	vi phạm bản quyền
VPBVNTD	văn phòng bảo vệ người tiêu dùng
VPCC	văn phòng công chứng
VPCN	văn phòng công nhận
VPCP	văn phòng chính phủ
VPCTN	văn phòng chủ tịch nước
VPDD	văn phòng đại diện
VPHC	vi phạm hành chính
VPHU	văn phòng huyện uỷ
VPKTST	 văn phòng kiến trúc sư trưởng
VPKV	văn phòng khu vực
VPLS	văn phòng luật sư
VPQH	văn phòng quốc hội
VPTT	văn phòng trung tâm
VPTƯ	văn phòng trung ương
VPĐD	văn phòng đại diện
VPĐDNN	văn phòng đại diện nước ngoài
VPĐKQSDĐ	văn phòng đăng ký quyền sử dụng đất
VQGBE	vườn quốc gia bến en
VQGTC	vườn quốc gia tràm chim
VQVN	vinh quang việt nam
VSAT	vệ sinh an toàn
VSATLĐ	vệ sinh an toàn lao động
VSATTP	vệ sinh an toàn thực phẩm
VSCC	vệ sinh công cộng
VSDT	vệ sinh dịch tễ
VSDTTW	vệ sinh dịch tể trung ương
VSDTTƯ	vệ sinh dịch tể trung ương
VSLĐ	vệ sinh lao động
VSMT	vệ sinh môi trường
VSMTNT	vệ sinh môi trường nông thôn
VSPD	vệ sinh phòng dịch
VSTBPN	vì sự tiến bộ phụ nữ
VSTP	vệ sinh thực phẩm
VSYTCC	vệ sinh y tế công cộng
VSĐC	vi sinh đại cương
VTBSG	vận tải biển sài gòn
VTCC	việt tân cải cách
VTCI	viễn thông công ích
VTDL	vận tải du lịch
VTDĐ	viễn thông di động
VTHH	vận tải hàng hóa
VTHK	vận tải hàng không
VTHKCC	vận tải hành khách công cộng
VTHKSG	vận tải hành khách sài gòn
VTHKĐS	vận tải hành khách đường sắt
VTHKĐSSG	vận tải hành khách đường sắt sài gòn
VTNN	vật tư nông nghiệp
VTQT	vận tải quốc tế
VTTB	vật tư thiết bị
VTTC	vươn tới thành công
VTTH	vật tư tổng hợp
VTTHPY	vật tư tổng hợp phú yên
VTTL	viêm tuyến tiền liệt
VTTLM	viêm tuyến tiền liệt mãn
VTTM	viêm tắc tĩnh mạch
VTTN	vi tính thu ngân
VTTPH	viên tránh thai phối hợp
VTTT	vận tốc tức thời
VTTĐ	vị trí tương đối
VTVN	viễn tượng việt nam
VTVT	vệ tinh viễn thám
VTXD	vật tư xăng dầu
VTYT	vật tư y tế
VTĐS	vận tải đường sắt
VTĐSHN	vận tải đường sắt hà nội
VUDNCNC	vườn ươm doanh nghiệp công nghệ cao
VVNTN	vừa và nhỏ tư nhân
VVSYTCC	viện vệ sinh y tế công cộng
VĐ	vô địch
VĐGQ	vô địch quốc gia
VĐHMNĐ	vận động hiến máu nhân đạo
VĐQG	vô địch quốc gia
VĐTG	vô địch thế giới
VĐV	vận động viên
VĐVQG	vận động viên quốc gia
XCLC	xe chất lượng cao
XD	xây dựng
XDCB	xây dựng cơ bản
XDCN	xây dựng công nghiệp
XDCSCT	xây dựng cơ sở chính trị
XDCT	xây dựng công trình
XDCTGT	xây dựng công trình giao thông
XDGV	xây dựng gò vấp
XDHK	xăng dầu hàng không
XDHN	xây dựng hà nội
XDKP	xây dựng không phép
XDKT	xây dựng kinh tế
XDKTMN	xây dựng kiến trúc miền nam
XDLL	xây dựng lực lượng
XDMT	xây dựng miền trung
XDNLN	xây dựng nông lâm nghiệp
XDNN	xây dựng nông nghiệp
XDQĐ	xăng dầu quân đội
XDTH	xây dựng thanh hóa
XDTL	xây dựng thủy lợi
XDTMSG	xây dựng thương mại sài gòn
XDVL	xây dựng việt lào
XDVN	xây dựng việt nam
XDĐT	xây dựng đô thị
XDĐTNĐ	xếp dỡ đường thủy nội địa
XGCT	xơ gan cổ trướng
XH	xã hội
XHCN	xã hội chũ nghĩa
XHCNVN	xã hội chũ nghĩa việt nam
XHDS	xã hội dân sự
XHHCTTH	xã hội hóa chương trình truyền hình
XHHGD	xã hội hóa giáo dục
XHNV	xã hội nhân văn
XHTD	xu hướng tính dục
XHTDTE	xâm hại tình dục trẻ em
XHTT	xã hội thông tin
XHVN	xã hội việt nam
XK	xuất khẩu
XKLD	xuất khẩu lao động
XKLĐ	xuất khẩu lao động
XKTS	xuất khẩu thủy sản
XKTV	xuất khẩu thuyền viên
XKVSĐT	xung kích vệ sinh đô thị
XLCTR	xử lý chất thải rắn
XLHN	xa lộ hà nội
XLNT	xử lý nước thải
XLNTCNTT	xử lý nước thải công nghiệp tập trung
XLNTTT	xử lý nước thải tập trung
XLTH	xử lý tín hiệu
XMHM	xi măng hoàng mai
XMHP	xi măng hải phòng
XMTC	xe máy thi công
XMTN	xi măng thái nguyên
XMVN	xi măng việt nam
XNCBTP	xí nghiệp chế biến thực phẩm
XNCK	xí nghiệp cơ khí
XNK	xuất nhập khẩu
XNKCN	xuất nhập khẩu công nghiệp
XNKDNS	xí nghiệp kinh doanh nước sạch
XNKDNSĐĐ	xí nghiệp kinh doanh nước sạch đống đa
XNKLT	xuất nhập khẩu lương thực
XNKNI	xuất nhập khẩu ngành in
XNKT	xuất nhập khẩu than
XNKTH	xuất nhập khẩu tổng hợp
XNKTS	xuất nhập khẩu thủy sản
XNLD	xí nghiệp liên doanh
XNLT	xí nghiệp lương thực
XNLTNT	xí nghiệp lương thực ninh thuận
XNNTTSKT	xí nghiệp nuôi trồng thủy sản kiến thụy
XNQD	xí nghiệp quốc doanh
XNTD	xí nghiệp tư doanh
XNTL	xí nghiệp thuốc lá
XNXD	xí nghiệp xây dựng
XPHC	xử phạt hành chính
XSKT	xổ số kiến thiết
XTDL	xúc tiến du lịch
XTNĐ	xoáy thuận nhiệt đới
XTTM	xúc tiến thương mại
XTVL	xúc tiến việc làm
XTXNK	xúc tiến xuất nhập khẩu
XTĐT	xúc tiến đầu tư
XVNT	xô viết nghệ tĩnh
XXST	xét xử sơ thẩm
XĐGN	xoá đói giảm nghèo
XĐTTVN	xe đạp thể thao việt nam
XĐXM	xe đạp xe máy
YDBL	y dược bảo long
YDTN	y dược tư nhân
YHCT	y học cổ truyền
YHCTHD	y học cổ truyền hải dương
YHLSBNĐ	y học lâm sàng bệnh nhiệt đới
YHLSCBNĐ	y học lâm sàng các bệnh nhiệt đới
YHLĐ	y học lao động
YKVN	y khoa việt nam
YT	y tế
YTBD	y tế bình dương
YTCC	y tế công cộng
YTDP	y tế dự phòng
YTLĐ	y tế lâm đồng
YTVN	y tế việt nam
ĐAKT	đồ án kiến trúc
ĐAQĐ	điện ảnh quân đội
ĐATQ	điện ảnh trung quốc
ĐAVN	điện ảnh việt nam
ĐB	đại biểu
ĐBBB	đồng bằng bắc bộ
ĐBCL	đảm bảo chất lượng
ĐBCT	đường bộ cao tốc
ĐBGPMB	đền bù giải phóng mặt bằng
ĐBGT	đền bù giải tỏa
ĐBGTĐT	đảm bảo giao thông đường thủy
ĐBHSXB	đánh bắt hải sản xa bờ
ĐBKK	đặc biệt khó khăn
ĐBP	điện biên phủ
ĐBQH	đại biểu quốc hội
ĐBSCL	đồng bằng sông cửu long
ĐBSH	đồng bằng sông hồng
ĐBTH	đền bù thiệt hại
ĐBTN	đại biểu thanh niên
ĐBTSXB	đánh bắt thủy sản xa bờ
ĐBVN	đường bộ việt nam
ĐBXB	đánh bắt xa bờ
ĐBĐT	điện báo điện thoại
ĐBĐTH	đoàn bóng đá thanh hóa
ĐBĐVN	đoàn bưu điện việt nam
ĐCNN	độ chia nhỏ nhất
ĐCNĐ	địa chính nhà đất
ĐCNĐĐT	địa chính nhà đất đô thị
ĐCQT	đẳng cấp quốc tế
ĐCS	đảng cộng sản
ĐCSLX	đảng cộng sản liên xô
ĐCSTQ	đảng cộng sản trung quốc
ĐCSVN	đảng cộng sản việt nam
ĐCTC	định chế tài chính
ĐCTCP	đoàn công tác chính phủ
ĐCXB	đại chiến xích bích
ĐCĐC	định canh định cư
ĐDNVK	đoàn doanh nghiệp việt kiều
ĐDTC	điều dưỡng trung cấp
ĐH	đại học
ĐHAG	đại học an giang
ĐHBC	đại học bán công
ĐHBK	đại học bách khoa
ĐHBKHN	đại học bách khoa hà nội
ĐHCLC	đại học chất lượng cao
ĐHCN	đại học công nghiệp
ĐHCNTT	đại học công nghệ thông tin
ĐHCNVC	đại hội công nhân viên chức
ĐHCQ	đại học chính quy
ĐHCT	đại học cần thơ
ĐHCĐ	đại học cao đẳng
ĐHCĐVN	đại hội công đoàn việt nam
ĐHDL	đại học dân lập
ĐHDLKT	đại học dân lập kỹ thuật
ĐHGTVT	đại học giao thông vận tải
ĐHHH	đại học hàng hải
ĐHHHVN	đại học hàng hải việt nam
ĐHHN	đại học hà nội
ĐHHP	đại học hải phòng
ĐHHT	đồng hương hà tĩnh
ĐHHĐ	đại học hiện đại
ĐHKH	đại học khoa học
ĐHKHTN	đại học khoa học tự nhiên
ĐHKHTNHN	đại học khoa học tự nhiên hà nội
ĐHKHXH	đại học khoa học xã hội
ĐHKHXHNV	đại học khoa học xã hội nhân văn
ĐHKN	điều hòa kinh nguyệt
ĐHKT	đại học kinh tế
ĐHKTQD	đại học kinh tế quốc dân
ĐHLĐ	đại hội liên đoàn
ĐHMTCN	đại học mỹ thuật công nghiệp
ĐHNH	đại học ngân hàng
ĐHNL	đại học nông lâm
ĐHNN	đại học nông nghiệp
ĐHNNHN	đại học ngoại ngữ hà nội
ĐHNT	đại học nghệ thuật
ĐHNĐ	điều hòa nhiệt độ
ĐHQB	đại học quảng bình
ĐHQG	đại học quốc gia
ĐHQGHN	đại học quốc gia hà nội
ĐHQGVN	đại học quốc gia việt nam
ĐHQN	đại học quy nhơn
ĐHQS	đại học quân sự
ĐHSK	đại học sân khấu
ĐHSKĐA	đại học sân khấu điện ảnh
ĐHSP	đại học sư phạm
ĐHSPBK	đại học sư phạm bắc kinh
ĐHSPHN	đại học sư phạm hà nội
ĐHSPKT	đại học sư phạm kỹ thuật
ĐHTB	đội hình tiêu biểu
ĐHTDTT	đại hội thể dục thể thao
ĐHTH	đại học tổng hợp
ĐHTHHN	đại học tổng hợp hà nội
ĐHTM	đại học thương mại
ĐHTN	đại học thái nguyên
ĐHTT	đại học tư thục
ĐHTV	đại học trà vinh
ĐHVH	đại học văn hóa
ĐHVHHN	đại học văn hóa hà nội
ĐHVL	đại học văn lang
ĐHXD	đại học xây dựng
ĐHYD	đại học y dược
ĐHYHN	đại học y hà nội
ĐHĐCQT	đại học đẳng cấp quốc tế
ĐHĐCĐ	đại hội đồng cổ đông
ĐHĐD	đại học đông dương
ĐHĐL	đại học đà lạt
ĐHĐLHQ	đại hội đồng liên hợp quốc
ĐHĐN	đại học đà nẵng
ĐKDN	đăng ký doanh nghiệp
ĐKDT	đăng ký dự thi
ĐKHK	đăng ký hộ khẩu
ĐKHKTT	đăng ký hộ khẩu thường trú
ĐKHĐ	đăng ký hoạt động
ĐKKD	đăng ký kinh doanh
ĐKKH	đăng ký kết hôn
ĐKKV	đa khoa khu vực
ĐKLA	đa khoa long an
ĐKLĐ	điều kiện lao động
ĐKPH	đăng ký phát hành
ĐKQG	điền kinh quốc gia
ĐKST	đa khoa sóc trăng
ĐKTC	đăng ký thế chấp
ĐKTQT	đại kiện tướng quốc tế
ĐKTT	đăng ký thường trú
ĐKTƯCT	đa khoa trung ương cần thơ
ĐKVN	đăng kiểm việt nam
ĐKVĐ	đương kim vô địch
ĐKVĐQG	đương kim vô địch quốc gia
ĐKXM	đăng ký xe máy
ĐKXT	đăng ký xét tuyển
ĐKĐT	điện kế điện tử
ĐLBTKL	định luật bảo toàn khối lượng
ĐLBTĐ	định luật bảo toàn điện
ĐLBĐ	đại lý bưu điện
ĐLCL	đo lường chất lượng
ĐLDK	điện lực dầu khí
ĐLHN	điện lực hà nội
ĐLLĐ	điện lực lâm đồng
ĐLNL	đại lý nhận lệnh
ĐLTL	điện lực từ liêm
ĐLTN	điện lực thái nguyên
ĐLTPHCM	điện lực thành phố hồ chí minh
ĐLTPKĐ	định luật thành phần không đổi
ĐLVN	điện lực việt nam
ĐLĐN	điện lực đà nẵng
ĐLĐĐ	điện lực đống đa
ĐMGD	đổi mới giáo dục
ĐMHN	đầu máy hà nội
ĐMTC	đầu mối trái cây
ĐNA	đông nam á
ĐNB	đông nam bộ
ĐNHC	đối ngoại hành chính
ĐNND	đối ngoại nhân dân
ĐNNTC	đại nam nhất thống chí
ĐNTLTB	đại nam thực lục tiền biên
ĐNÁ	đông nam á
ĐPCTPMT	đội phòng chống tội phạm ma túy
ĐPT	đa phương tiện
ĐPTTH	đài phát thanh truyền hình
ĐQLĐS	đoạn quản lý đường sông
ĐRL	điểm rèn luyện
ĐSCT	đường sắt cao tốc
ĐSQ	đại sứ quán
ĐSVN	đường sắt việt nam
ĐSĐMTQ	đại sứ đặc mệnh toàn quyền
ĐT	điện thoại
ĐTB	điểm trung bình
ĐTBC	điểm trung bình chung
ĐTBT	đầu tư bình thuận
ĐTBĐ	đội tuyển bóng đá
ĐTBĐQG	đội tuyển bóng đá quốc gia
ĐTBĐVN	đội tuyển bóng đá việt nam
ĐTCBL	điều tra chống buôn lậu
ĐTCC	điện thoại công cộng
ĐTCK	đầu tư chứng khoán
ĐTCĐ	điện thoại cố định
ĐTDD	điện thoại di động
ĐTDTBV	đi tìm dấu tích ba vua
ĐTDĐ	điện thoại di động
ĐTGQ	đội tuyển quốc gia
ĐTHA	đội thi hành án
ĐTHT	đông trùng hạ thảo
ĐTHVN	đài truyền hình việt nam
ĐTLA	đồng tâm long an
ĐTLB	đô thị lấn biển
ĐTLT	đào tạo liên thông
ĐTML	điện toán mạng lưới
ĐTMTT	đô thị mới thủ thiêm
ĐTNCKH	đề tài nghiên cứu khoa học
ĐTNCS	đoàn thanh niên cộng sản
ĐTNM	điểm thu nhận máy
ĐTNN	đầu tư nước ngoài
ĐTNT	đối tượng nộp thuế
ĐTNVN	đài tiếng nói việt nam
ĐTNĐ	đường thủy nội địa
ĐTPT	đầu tư phát triển
ĐTPTNHN	đầu tư phát triển nhà hà nội
ĐTQG	đội tuyển quốc gia
ĐTQV	đại tướng quân vương
ĐTRNN	đầu tư ra nước ngoài
ĐTST	đô thị sinh thái
ĐTTC	đào tạo tín chỉ
ĐTTCP	đoàn thanh tra chính phủ
ĐTTH	điện toán tự hành
ĐTTN	đầu tư trong nước
ĐTTP	đấu thầu trái phiếu
ĐTVN	đội tuyển việt nam
ĐTVT	điện tử viễn thông
ĐTVTQG	điện tử viễn thông quốc gia
ĐTXD	đầu tư xây dựng
ĐTXDCB	đầu tư xây dựng cơ bản
ĐTXDHN	đầu tư xây dựng hà nội
ĐTĐH	đào tạo đại học
ĐVBC	đơn vị bầu cử
ĐVCĐ	đoàn viên công đoàn
ĐVDT	đơn vị được trao
ĐVHD	động vật hoang dã
ĐVKT	đơn vị kỉ thuật
ĐVSNCL	đơn vị sự nghiệp công lập
ĐVTL	đơn vị tâm lý
ĐVTN	đoàn viên thanh niên
ĐVTTN	đoàn viên thanh thiếu niên
ĐVTV	đơn vị thiên văn
ĐVUT	đoàn viên ưu tú
ĐVĐD	đơn vị độ dài
ĐXMT	đường xưa mây trắng
ĐĐCC	địa đạo củ chi
ĐĐK	đại đoàn kết
ĐỒNG/KG	đồng một kí lô gam
ƯTXT	ưu tiên xét tuyển
